adadadadad	TRUE
adadadadad	TRUE
adadcccdcd	TRUE
adadcccddd	TRUE
adbcbcbcad	TRUE
adbcbcbcad	TRUE
adbcddadbc	TRUE
adbcddadbc	TRUE
adccbcadbc	TRUE
adccbcadda	TRUE
addadcdbcb	TRUE
addadcdbcc	TRUE
adddaddbcd	TRUE
adddaddcad	TRUE
bcadbcdada	TRUE
bcadbcdadc	TRUE
bcbcadcbcb	TRUE
bcbcadcbcb	TRUE
bcbcdbcbcd	TRUE
bcbcdbcccd	TRUE
bcccaddadd	TRUE
bcccaddadd	TRUE
bcdadddbcb	TRUE
bcdadddbcc	TRUE
bcddcadbcd	TRUE
bcddcaddda	TRUE
cadcadccbc	TRUE
cadcadcccc	TRUE
cbcadbccbc	TRUE
cbcadbccdb	TRUE
cbccddadbc	TRUE
cbccddbcad	TRUE
ccadddbcca	TRUE
ccadddcbcc	TRUE
ccdbcddcad	TRUE
ccdcadadbc	TRUE
cdbcdcbccc	TRUE
cdbcdcdcad	TRUE
dadadbcdbc	TRUE
dadadbcddc	TRUE
dadcddbcad	TRUE
dadcddcada	TRUE
dbcbcdbccd	TRUE
dbcbcdcadc	TRUE
dcadaddcbc	TRUE
dcadadddcd	TRUE
dccccdcbcd	TRUE
dcccdadcbc	TRUE
ddbcbcccbc	TRUE
ddbcbcccca	TRUE
aaaaaadbca	FALSE
aaaaabadab	FALSE
aaccdbbbad	FALSE
aaccdbcdaa	FALSE
abaddddbac	FALSE
abbaaaabad	FALSE
abdccbbdaa	FALSE
abdccbbddb	FALSE
accaaaabdb	FALSE
accaaacbcd	FALSE
adadbcbacd	FALSE
adadbddbac	FALSE
addabbcdbc	FALSE
addabbdcbc	FALSE
babddcbacb	FALSE
babdddccdc	FALSE
bbbaabccca	FALSE
bbbaacacac	FALSE
bbdcdddaad	FALSE
bbddaacdca	FALSE
bccbadbbbb	FALSE
bccbbaaada	FALSE
bdadcbbdbc	FALSE
bdadcbcbbb	FALSE
bddbdcbddc	FALSE
bddbddbacb	FALSE
cabcdaccbc	FALSE
cabcdbdbcb	FALSE
cbabaaaddd	FALSE
cbabaabcdd	FALSE
cbccdcadac	FALSE
cbccdcdbbc	FALSE
ccbacdcabc	FALSE
ccbadadabc	FALSE
ccdcaacccd	FALSE
ccdcaacdaa	FALSE
cdcacbdcba	FALSE
cdcaccadbd	FALSE
daacdbaadb	FALSE
daacddccac	FALSE
dadabdbdcd	FALSE
dadacabaac	FALSE
dbbcdaabcb	FALSE
dbbcdadbcd	FALSE
dcaabcdcdc	FALSE
dcaabdccdd	FALSE
dccccaccbd	FALSE
dccccbbccd	FALSE
ddbadccacd	FALSE
ddbaddbcdc	FALSE
adadadadada	TRUE
adadadadadb	TRUE
adadcdadbcc	TRUE
adadcdadcad	TRUE
adbcbcadbcd	TRUE
adbcbcadbcd	TRUE
adbcdcdcbca	TRUE
adbcdcdddbc	TRUE
adccadcdbcd	TRUE
adccadcdcdd	TRUE
addaddadadd	TRUE
addaddadbcb	TRUE
adddaddbcad	TRUE
adddaddbcbc	TRUE
bcadbcddadc	TRUE
bcadbcddbcb	TRUE
bcbcadbcdcd	TRUE
bcbcadbcddd	TRUE
bcbcdbcbccb	TRUE
bcbcdbccadb	TRUE
bcccadddadc	TRUE
bcccadddcbc	TRUE
bcdadcdcbcd	TRUE
bcdaddaddca	TRUE
bcddbcdcada	TRUE
bcddbcdcbcd	TRUE
cadcadadcad	TRUE
cadcadadcad	TRUE
cbcadbccbcb	TRUE
cbcadbcccdb	TRUE
cbccdcadbca	TRUE
cbccdcadcdb	TRUE
ccbcbcaddcd	TRUE
ccbcbcbcada	TRUE
ccdcdcadbcc	TRUE
ccdcdccbccd	TRUE
cdcadaddbca	TRUE
cdcadbcadbc	TRUE
dadadccadcd	TRUE
dadadccbcad	TRUE
daddadadbcd	TRUE
daddadbcbcc	TRUE
dbcbcdbcbca	TRUE
dbcbcdbcbcb	TRUE
dcadbccddca	TRUE
dcadbcdbcbc	TRUE
dcdadadadcc	TRUE
dcdadadadda	TRUE
ddbcccbccad	TRUE
ddbccccadbc	TRUE
aaaaaadbcaa	FALSE
aaaaabadbab	FALSE
aacccacabcb	FALSE
aacccacbcbb	FALSE
abbaadccadb	FALSE
abbaaddadbc	FALSE
abdcddddacc	FALSE
abddaaabccb	FALSE
accbaacdaab	FALSE
accbaacddcd	FALSE
adadbaabcab	FALSE
adadbaadbcd	FALSE
addbacbaccc	FALSE
addbaccdbcd	FALSE
babdccababb	FALSE
babdcccddcc	FALSE
bbadacdbadb	FALSE
bbadadabdcb	FALSE
bbdbbababdb	FALSE
bbdbbabaccc	FALSE
bcbddadbcba	FALSE
bcbddcccaca	FALSE
bdacccacdcd	FALSE
bdaccdccbda	FALSE
bddcccdcabd	FALSE
bddccdbdaca	FALSE
cacaadabacb	FALSE
cacaadcadcc	FALSE
cbacbaccacb	FALSE
cbacbadadcc	FALSE
cbcddcadbbd	FALSE
cbdaabadbda	FALSE
ccbbccbcaad	FALSE
ccbbcccacca	FALSE
ccddbccbdbc	FALSE
ccddcaccabc	FALSE
cdcacbdcabd	FALSE
cdcaccddbaa	FALSE
daacacbcddc	FALSE
daacbbbdcad	FALSE
dadbaaacdbc	FALSE
dadbaabacba	FALSE
dbbdcccacba	FALSE
dbbdccccaca	FALSE
dcabbcbbaab	FALSE
dcabbcdaaac	FALSE
dccddbddbac	FALSE
dccddcadcba	FALSE
ddbccadddac	FALSE
ddbccbacabb	FALSE
adadadadadbc	TRUE
adadadadbcbc	TRUE
adadcdcdadad	TRUE
adadcdcdadbc	TRUE
adbcbcbcdada	TRUE
adbcbcbcdadc	TRUE
adbcdddcadbc	TRUE
adbcddddadbc	TRUE
adccaddbcadd	TRUE
adccaddddada	TRUE
addaddbcdadd	TRUE
addaddbcdbcd	TRUE
adddbcbcccad	TRUE
adddbccadadd	TRUE
bcadbcdcadbc	TRUE
bcadbcdcbcbc	TRUE
bcbcadcadbcd	TRUE
bcbcadcaddad	TRUE
bcbcdadbcadd	TRUE
bcbcdadbcbca	TRUE
bccbccdbcadb	TRUE
bccbccdcadbc	TRUE
bccddccbccad	TRUE
bccddcccbcbc	TRUE
bcdccadadbcd	TRUE
bcdccadbccad	TRUE
cadbcaddadca	TRUE
cadbcaddadcd	TRUE
cadddcbcccad	TRUE
cadddccadddd	TRUE
cbccadddbcad	TRUE
cbccbcadbcda	TRUE
ccaddcbccbcc	TRUE
ccaddccbcadb	TRUE
ccdcbcadbcad	TRUE
ccdcbcccaddd	TRUE
cdcadbccdbcd	TRUE
cdcadbccdbcd	TRUE
dadadcdbcddb	TRUE
dadadcdcbccd	TRUE
daddadcdbcca	TRUE
daddaddadccc	TRUE
dbccadbccdbc	TRUE
dbccadbcdadc	TRUE
dcadccbccddc	TRUE
dcadccbcdccb	TRUE
dcdadbcdbcad	TRUE
dcdadcadccbc	TRUE
ddbccbcadccc	TRUE
ddbccbcbccdb	TRUE
aaaaabbcdbcb	FALSE
aaaabbdabccb	FALSE
aacdcbbaddac	FALSE
aacdcccbabda	FALSE
abbcacbbcabd	FALSE
abbcacbddbcd	FALSE
abddddababcb	FALSE
abddddbdccab	FALSE
accbdbbacccc	FALSE
acccaacaabda	FALSE
adadcddaddba	FALSE
adaddaacaacd	FALSE
addbcdcbadda	FALSE
addbcdcbddac	FALSE
bacaaacccdbc	FALSE
bacaabbdddbc	FALSE
bbaacbcaaadb	FALSE
bbaacbccabcc	FALSE
bbccdadddabb	FALSE
bbccdbabbbbc	FALSE
bcbbacbabcab	FALSE
bcbbacdcaccb	FALSE
bcddcccddcaa	FALSE
bcddccddbaba	FALSE
bdcdabdacabb	FALSE
bdcdacbbdadc	FALSE
cabbbdcaadcb	FALSE
cabbbdcbdadc	FALSE
cadddadddcbd	FALSE
cbaaaaccacad	FALSE
cbcccccccbdd	FALSE
cbcccdcbdbda	FALSE
ccbabbadadbb	FALSE
ccbabcaddacb	FALSE
ccdccbdadbdd	FALSE
ccdccccddbbc	FALSE
cdcaadbcccdd	FALSE
cdcaadcbdbaa	FALSE
daadadcdaaab	FALSE
daadbaddcdbc	FALSE
dadccdcaabdc	FALSE
dadcdcadccab	FALSE
dbcbacabdadc	FALSE
dbcbadcdadaa	FALSE
dcadacbdcacb	FALSE
dcadadaadbca	FALSE
dcdabadcacca	FALSE
dcdabbcacdcb	FALSE
ddbbccadacca	FALSE
ddbbccccaaba	FALSE
adadadadadbcb	TRUE
adadadadbcbcb	TRUE
adadcdcadaddb	TRUE
adadcdcadbcdb	TRUE
adbcbcbccdbcd	TRUE
adbcbcbcdadca	TRUE
adbcddcdcbcdc	TRUE
adbcdddadcdad	TRUE
adccbcdadbcbc	TRUE
adccbcdcadcad	TRUE
addaddcdadcbc	TRUE
addaddcdbcadc	TRUE
adddbcbcdadad	TRUE
adddbcbcdadca	TRUE
bcadcadadcadc	TRUE
bcadcadadcdbc	TRUE
bcbcadcccccbc	TRUE
bcbcadccdadad	TRUE
bcbcdadadddbc	TRUE
bcbcdadbcbcad	TRUE
bccbcbcdbcdcb	TRUE
bccbcbcdcadad	TRUE
bcdadbcbcadbc	TRUE
bcdadbcbcbcad	TRUE
bcdcdadaddbcd	TRUE
bcdcdadbcadca	TRUE
cadbcadddadcd	TRUE
cadbcbcadadad	TRUE
caddddcadcadd	TRUE
cbcadadadadad	TRUE
cbccbcadbcada	TRUE
cbccbcadcccad	TRUE
ccadccadadbca	TRUE
ccadccbcbccbc	TRUE
ccdbcddaddadd	TRUE
ccdbcddbcdada	TRUE
cdcadbcadddad	TRUE
cdcadbcbcbcbc	TRUE
dadadcbcbcdda	TRUE
dadadcbccbccd	TRUE
daddbccdadcdb	TRUE
daddbccdbcada	TRUE
dbcbcdbcbcdcb	TRUE
dbcbcdbccdada	TRUE
dcadbccddddbc	TRUE
dcadbcdadadad	TRUE
dccdcbcccddcb	TRUE
dccdcbccdcadd	TRUE
ddbcbcbccdadb	TRUE
ddbcbcbccdadb	TRUE
aaaaaaabccdac	FALSE
aaaaabadbadcd	FALSE
aacbdbcccaddc	FALSE
aacbdcaadcbaa	FALSE
abbbaaddccabd	FALSE
abbbadbbcdbad	FALSE
abddcbbdbaacb	FALSE
abddcbcacaddc	FALSE
accbcaaadabac	FALSE
accbcabaccccc	FALSE
adacbddbadabc	FALSE
adacbddddaddd	FALSE
addbbddddaccc	FALSE
addbcaccadbca	FALSE
bacbabadacbdb	FALSE
bacbabdacbcdb	FALSE
bbbaadbdbbbdc	FALSE
bbbabaaabdddc	FALSE
bbdcabacacbdd	FALSE
bbdcabadadcbc	FALSE
bccabccacabcb	FALSE
bccabdccdaadb	FALSE
bdacbbccdaaad	FALSE
bdaccacddddac	FALSE
bddaaccbdddda	FALSE
bddaaccdcbbca	FALSE
cabcdaabadbac	FALSE
cabcdabacadad	FALSE
cadddddcaaadb	FALSE
cbaaabbdaaacd	FALSE
cbcdcadcbdcdb	FALSE
cbcdcbaaaddab	FALSE
ccbcabdddbbca	FALSE
ccbcacbadacac	FALSE
cdaacddbdcbcb	FALSE
cdaacdddbbbbc	FALSE
cdcbdccddccdd	FALSE
cdcbdcdbbbccd	FALSE
dabaddbcdcabd	FALSE
dabbaaaccadcd	FALSE
dbaaabdaccaac	FALSE
dbaaacabaadcc	FALSE
dbcbbaccadadb	FALSE
dbcbbacdaadad	FALSE
dcacccccccabb	FALSE
dcacdaadcaacc	FALSE
dcdadabdacbbd	FALSE
dcdadaccadadd	FALSE
ddbcadaacaddb	FALSE
ddbcadccdbaba	FALSE
adadadadadadad	TRUE
adadadadadbcad	TRUE
adadccadcbcadb	TRUE
adadccbcadbccc	TRUE
adbcbcadadcadb	TRUE
adbcbcadadccbc	TRUE
adbcddbcdadcca	TRUE
adbcddbcdcadad	TRUE
adccaddadcdcca	TRUE
adccaddbcadbca	TRUE
addadccdcbcdcb	TRUE
addadccddadcad	TRUE
adddccaddbcdbc	TRUE
adddccccadadad	TRUE
bcadcbcdbcbcbc	TRUE
bcadcbcdcdccbc	TRUE
bcbcbcadcadbcc	TRUE
bcbcbcadcadcbc	TRUE
bcbcdcddaddcda	TRUE
bcbcdcdddbccbc	TRUE
bcccadbcadadad	TRUE
bcccadbcadcdda	TRUE
bcdadbccbccbcb	TRUE
bcdadbccbcddcd	TRUE
bcdcddadadddbc	TRUE
bcdcddcadadadc	TRUE
cadbccddddddda	TRUE
cadbcdadadadcc	TRUE
cbcadadbccdbcc	TRUE
cbcadadbcdcdbc	TRUE
cbccddccbcbcad	TRUE
cbccddccdaddad	TRUE
ccbccbcdbccbcd	TRUE
ccbccbcdbcdcbc	TRUE
cdadadbcbccdbc	TRUE
cdadadbccadada	TRUE
cdccadadadbcbc	TRUE
cdccadadadbcca	TRUE
dadadddcdcbcdc	TRUE
dadbcadadadcad	TRUE
daddbcccdcbcdd	TRUE
daddbcccdddbcb	TRUE
dbcbcdaddcbcad	TRUE
dbcbcdbcbcadbc	TRUE
dcadadadadbcbc	TRUE
dcadadadadbcbc	TRUE
dccdbcadbccddd	TRUE
dccdbcbcbccddc	TRUE
ddbcbcaddadcad	TRUE
ddbcbcbcccddbc	TRUE
aaaaaaabccdacc	FALSE
aaaaababadcdcc	FALSE
aacbdacdaccaaa	FALSE
aacbdacdcbcbbd	FALSE
abbaadbabddbcd	FALSE
abbaadccdbddcd	FALSE
abddcccbcdddac	FALSE
abddccdacdbadd	FALSE
accabcdabbaccb	FALSE
accabddddbcbba	FALSE
adacdcaddbacaa	FALSE
adacdcbbdabbaa	FALSE
addcacdbddbbdd	FALSE
addcbabdccdcab	FALSE
bacacaddcbbaaa	FALSE
bacacbabdbdbdd	FALSE
bbaccbddaadabb	FALSE
bbaccccddcbddd	FALSE
bbdbcabbbdcbbb	FALSE
bbdbcbdabbaacb	FALSE
bcbdbdbcdddcab	FALSE
bcbdcbbbabadaa	FALSE
bdacaadabacadb	FALSE
bdacabdbdbbcaa	FALSE
bdcdcacdaadaac	FALSE
bdcdcbbadaabac	FALSE
cabcaabbdabcda	FALSE
cabcaaddacaadd	FALSE
cbaabcddddaabd	FALSE
cbaabdaacbacbc	FALSE
cbcbbbcaccddbd	FALSE
cbcbbbdcaadabb	FALSE
ccadcaddcccbbb	FALSE
ccadcccacbbdbd	FALSE
ccdbdaddbdbdda	FALSE
ccdbdcdaabccab	FALSE
cdcbbdbdbdbbbd	FALSE
cdcbcdbaadabdb	FALSE
daadddbbcacaaa	FALSE
daadddbbddccbb	FALSE
dadcaaaaddcbac	FALSE
dadcaaadccaccc	FALSE
dbcabcbbcbadba	FALSE
dbcabccadbaada	FALSE
dcacadbcddadcb	FALSE
dcacadcdcdacab	FALSE
dcdacccacbacdc	FALSE
dcdacdadcbcbaa	FALSE
ddbccbacacbcab	FALSE
ddbcccabddbddb	FALSE
adadadadadbcbcc	TRUE
adadadadadbcbcc	TRUE
adadcdadbcbccbc	TRUE
adadcdadbcddccd	TRUE
adbcbcadcdcadbc	TRUE
adbcbcadcdccbca	TRUE
adbcddadbcdbcad	TRUE
adbcddadbcdcadb	TRUE
adccbcadadbcadd	TRUE
adccbcadbcbcadc	TRUE
addaddccddadddb	TRUE
addadddadcadadb	TRUE
adddbcaddccadca	TRUE
adddbcadddadadb	TRUE
bcadcadadbcddad	TRUE
bcadcadadccadbc	TRUE
bcbcadcadaddddc	TRUE
bcbcadcadbcbcad	TRUE
bcbcdaddaddddbc	TRUE
bcbcdaddbcadcca	TRUE
bccbcccadbcadad	TRUE
bccbcccaddcdcbc	TRUE
bcdadadbcdcadcd	TRUE
bcdadadcbcadadd	TRUE
bcdccdbcddbcbcb	TRUE
bcdccdbcddccdad	TRUE
cadbcbcbcadcadb	TRUE
cadbcbcbcadcbcc	TRUE
cadddccadcadadd	TRUE
cadddcccadadccb	TRUE
cbcccbcdaddbcad	TRUE
cbcccbcddadcbcc	TRUE
ccbcaddaddbcbca	TRUE
ccbcadddadadbcb	TRUE
ccdcadbcbccaddb	TRUE
ccdcaddccddadcd	TRUE
cdbcdadbcaddadd	TRUE
cdbcdadbcddcbcc	TRUE
dadadcadbccdbca	TRUE
dadadcadbcdadad	TRUE
daddbcadadcbcdb	TRUE
daddbcadbcbcbca	TRUE
dbcbcccddbcadad	TRUE
dbcbccdadaddccb	TRUE
dcadadcddccdadb	TRUE
dcadaddadadbcbc	TRUE
dccdcbccaddcdbc	TRUE
dccdcbcccadcbca	TRUE
ddbcbcbcbcbcada	TRUE
ddbcbcbcbcbcada	TRUE
aaaaabbccbdbabb	FALSE
aaaaabbcddaccbd	FALSE
aacdaadbabcabdd	FALSE
aacdabbdccadcaa	FALSE
abbadcaaaacbcab	FALSE
abbadcaccdcadbb	FALSE
abddaadcbbcdcdd	FALSE
abddabaaacabcac	FALSE
accaabadcbcabbc	FALSE
accaabcdaaaccda	FALSE
adadbbbdbbcdada	FALSE
adadbbdbaacabac	FALSE
addbbdcaadddadd	FALSE
addbcabbbcbbcaa	FALSE
babdbaddacbbbdc	FALSE
babdbbbacaacabc	FALSE
bbaccdcacdcadca	FALSE
bbaccddbbbdcddc	FALSE
bbcdcdadbcdaaab	FALSE
bbcddbbcdbdbcdd	FALSE
bcbcabddbcaacdc	FALSE
bcbcadbbcddbabd	FALSE
bdaabbdaabcadac	FALSE
bdaabccbaadabcb	FALSE
bdccbbbbddcbbbb	FALSE
bdccbcbadacabbd	FALSE
cabacbccccbdbdc	FALSE
cabacbddbdaaadc	FALSE
caddcdbdadabccd	FALSE
cadddbababdabac	FALSE
cbcccaaddabcbac	FALSE
cbcccbbacccacdb	FALSE
ccbadcbaddddcba	FALSE
ccbaddabcdcabdc	FALSE
ccddacbbbacadda	FALSE
ccddacdaddcbcdb	FALSE
cdcabdbcbcbcbcb	FALSE
cdcabdcbddddbdd	FALSE
daabddbbcabacbb	FALSE
daabddcbccdbccd	FALSE
dadacccbacdcbad	FALSE
dadacdabbaacbba	FALSE
dbbdadddacaabdd	FALSE
dbbdcbaccaccdaa	FALSE
dcabadbbcdbcdbb	FALSE
dcabbaddbacacbd	FALSE
dccdbacbcdcbaca	FALSE
dccdbcbcacbcbaa	FALSE
ddbbaadcacadadb	FALSE
ddbbabaabbbcdaa	FALSE
adadadadbcadcada	TRUE
adadadadbcbcddbc	TRUE
adadcbcddadcbcda	TRUE
adadccaddcddcadb	TRUE
adbcaddcddcbcadc	TRUE
adbcadddadbcadad	TRUE
adbcdbcbcadadadb	TRUE
adbcdbcbccdadada	TRUE
adcbcdbcddbccccd	TRUE
adcbcdcadbccdadd	TRUE
addadbcbcddadadb	TRUE
addadbccccdaddad	TRUE
addcddcbcbcccdad	TRUE
adddadadbccdddbc	TRUE
bcadbcbcbcadbcdc	TRUE
bcadbcbcbcdbcbcd	TRUE
bcadddddbcaddcdc	TRUE
bcbcadadadadbcbc	TRUE
bcbccbcadccbcadc	TRUE
bcbccbcadccccdcc	TRUE
bccadddadbccadbc	TRUE
bccadddadcddaddd	TRUE
bccdccdbcadbcada	TRUE
bccdccdcadaddcbc	TRUE
bcdcbcdcadbcccbc	TRUE
bcdcbcdccadbcbcd	TRUE
cadbcadbcdccbcad	TRUE
cadbcadccadadadb	TRUE
cbcadadcadccadad	TRUE
cbcadadcadccdada	TRUE
cbccccbcdadcccad	TRUE
cbcccccbcddadddb	TRUE
ccbcaddaddccccca	TRUE
ccbcaddbcadcadad	TRUE
ccdcbcbccaddbcbc	TRUE
ccdccbcadbccadda	TRUE
cdcbcbcadcdcdbca	TRUE
cdcbcbcbcadaddbc	TRUE
dadadcddcadadcda	TRUE
dadadcdddbcdccdb	TRUE
daddadddbccdbcad	TRUE
daddbcadadaddcad	TRUE
dbccadbcadccbcdd	TRUE
dbccadbcbcbcbcdc	TRUE
dcadcbcdbcadadda	TRUE
dcadcbcdccaddada	TRUE
dcdbcaddbcadbccd	TRUE
dcdbcaddbcbcaddc	TRUE
ddbcbcdcadbcccbc	TRUE
ddbcbcdccddaddcd	TRUE
aaaabacaaddbbdcd	FALSE
aaaabbdacaccbccc	FALSE
aacbdcabddbaaccb	FALSE
aacbdcbbdbadcaad	FALSE
abadcabcbccddaca	FALSE
abadcabdbdacdbac	FALSE
abdbbbbbccbdbcbc	FALSE
abdbbcccdadbcaac	FALSE
acbdcdcbabdcabdb	FALSE
acbdcdcddccabbcd	FALSE
adacaaccacccccca	FALSE
adacaccdadbcabdb	FALSE
adcdbbdaabbbcdaa	FALSE
adcdcaccacaacdac	FALSE
babcaaabaddacaba	FALSE
babcaadababbadcb	FALSE
baddcbccbdbbcbcb	FALSE
baddcccbccbbabcc	FALSE
bbccccadbbcbccaa	FALSE
bbccccccddcbbdca	FALSE
bcbbacbddcbacbab	FALSE
bcbbbabcccbddbdd	FALSE
bcdcaadaacbcdcca	FALSE
bcdcabaabaadcaad	FALSE
bdcbccdadccaaaca	FALSE
bdcbccddcbabadcc	FALSE
caadcbcadbaccbba	FALSE
caadccdadcabbdab	FALSE
caddbcadbbcdddda	FALSE
caddbcdadcacdbbd	FALSE
cbcbbcabacabbaba	FALSE
cbcbbcddbbbbdacb	FALSE
ccadcdbbbbbccbcd	FALSE
ccaddaccbdbaabda	FALSE
ccdccabcdddccabd	FALSE
ccdccbccabcabcdd	FALSE
cdcbbdabddddccbd	FALSE
cdcbcabcccbaccca	FALSE
daaccdcbdbdcdddd	FALSE
daacdacdbddcccca	FALSE
dadbaadaddcbcbab	FALSE
dadbabbbadcddcdb	FALSE
dbbdbadadacabdca	FALSE
dbbdbbabbccdabbb	FALSE
dcacabcdbddadbca	FALSE
dcacacbcbbddcdcb	FALSE
dcdabccdcadccdda	FALSE
dcdabdacaadcaada	FALSE
ddbcbbcccaccbccd	FALSE
ddbcbcbcababacba	FALSE
adadadadadadddbcc	TRUE
adadadadbcadaddcd	TRUE
adadcbcccbcdbcccd	TRUE
adadcbccdcbcbcbcd	TRUE
adbcaddadadbcdcad	TRUE
adbcaddadbccddcda	TRUE
adbcdbcdccdcadccb	TRUE
adbcdbcddadbccadc	TRUE
adcbcdcadadcadccb	TRUE
adcbcdcadcaddadca	TRUE
addadccadadbcadad	TRUE
addadccbcaddcbcca	TRUE
adddbccdcadbcbcad	TRUE
adddbccdcdadbccbc	TRUE
bcadbcdccbcbcbcbc	TRUE
bcadbcdcccadddbca	TRUE
bcbcadaddbcadadbc	TRUE
bcbcadaddbcadbcad	TRUE
bcbccbcccdcddbcad	TRUE
bcbccbccdbccdbccd	TRUE
bccbcadbcccbcbccc	TRUE
bccbcadbcdadaddbc	TRUE
bccddadadcbcbcccc	TRUE
bccddadcadadbcbca	TRUE
bcdccdcadadadbcbc	TRUE
bcdccdccbcbccadbc	TRUE
cadbcadbccbcadbcb	TRUE
cadbcadbccbcdadbc	TRUE
caddbcdddcadddbcd	TRUE
caddcadadbcbcbcad	TRUE
cbccbccbcbccadcad	TRUE
cbccbccbcbccdcbcb	TRUE
ccaddbccdcbccadca	TRUE
ccaddbccddadadadc	TRUE
ccdbcaddcdcadbcad	TRUE
ccdbcbcbcbcadcbcd	TRUE
cdbcddadbcadadccb	TRUE
cdbcddadccaddadbc	TRUE
dadadaddddadbcdbc	TRUE
dadadbcadbccaddad	TRUE
dadcddcbccdddcccd	TRUE
dadcdddbcdbcadbcc	TRUE
dbcbcbcdadcdaddbc	TRUE
dbcbcbcdcdbcadada	TRUE
dcadadcbcdcadcccc	TRUE
dcadaddadaddcddbc	TRUE
dcccdccdadcadbcdc	TRUE
dcccddbcccbcadcad	TRUE
ddbcadbcbccaddbcd	TRUE
ddbcadbccddbcadad	TRUE
aaaaaaddbcbacadba	FALSE
aaaabadbcacaccbdc	FALSE
aacbbbdaaabcdaaaa	FALSE
aacbbcaabcddbaabd	FALSE
abaddcbdaadddccda	FALSE
abaddddaacdccbbdd	FALSE
abdbaddabbbabaaad	FALSE
abdbcbadbdabdbacb	FALSE
acbdaacdddadccccc	FALSE
acbdacbabbadcbaad	FALSE
adabbddbbcdbdcacb	FALSE
adabcabddbddbdbac	FALSE
addbaabcccabacbcb	FALSE
addbabcbcadbcabbd	FALSE
bacabbabaababaccc	FALSE
bacabbdbbdcdccdcc	FALSE
bbabacbbddbdadaba	FALSE
bbabacbcccaccccbb	FALSE
bbcdacbbcbbcacbda	FALSE
bbcdacddaadabbdbd	FALSE
bcbbdcdbbacdcccbb	FALSE
bcbbddaddaddcbcdd	FALSE
bdaabadbddadaacca	FALSE
bdaabbdacaccdbdaa	FALSE
bdcdabacdbacadcab	FALSE
bdcdabbccdcbddccc	FALSE
cabacdbdadcbddadd	FALSE
cabadaababbaaaaba	FALSE
cadbbddcdaccabcdb	FALSE
cadbcaaabdbbbaaab	FALSE
cbbddadbbdaadabcb	FALSE
cbbddccccbdbdabad	FALSE
ccaaddbbbdbaaabca	FALSE
ccaaddbdbdbbcbbdd	FALSE
ccdabdadacccbaacd	FALSE
ccdaccaacdddbdbdb	FALSE
cdbccbabbdacddcda	FALSE
cdbccbadcccccadcc	FALSE
daabacadbbccbabcb	FALSE
daabacbccdcbccbad	FALSE
dacdbbaacbbdaadcd	FALSE
dacdbcccabaccdcbc	FALSE
dbbbcabbcdddabaab	FALSE
dbbbccbcbcbaccdda	FALSE
dcaadbccadabdadba	FALSE
dcaadcaadaadbcacb	FALSE
dccddcadcdbbbbdbb	FALSE
dccddcdbdabdcabbb	FALSE
ddbcaaadaacdabaaa	FALSE
ddbcaabcdababdbbd	FALSE
adadadadadbcadddbc	TRUE
adadadadadcbcadbcb	TRUE
adadcbcdbcadbccdad	TRUE
adadcbcdbcbcaddcdc	TRUE
adbcbcadadbcbcadbc	TRUE
adbcbcadadbcbcbccb	TRUE
adbcdbcddadcbccbcd	TRUE
adbcdcadcadcadcadb	TRUE
adccadaddcadbcbcbc	TRUE
adccadbcbcbcbcadad	TRUE
addadcccdcbcadbccb	TRUE
addadcccddbcbcdcbc	TRUE
adddbcadadccccadcc	TRUE
adddbcadbcbccdbccb	TRUE
bcadbcccadccdadcbc	TRUE
bcadbcccbcbcdadadd	TRUE
bcbcadbcaddadbccbc	TRUE
bcbcadbcaddbcdcada	TRUE
bcbcdadadbcadcadad	TRUE
bcbcdadadbccddadad	TRUE
bccbcbcdbcdadbcbcc	TRUE
bccbcbcdcadcdcadad	TRUE
bccdccbcdcdcadbcad	TRUE
bccdccbcddcdddccda	TRUE
bcdcaddccbcccbcbca	TRUE
bcdcbcadcccccadadd	TRUE
cadaddbcaddbccadbc	TRUE
cadaddbcbcdcccadcc	TRUE
caddbccadadadbcddb	TRUE
caddbccadbcbcccada	TRUE
cbcbcccadadbccbccb	TRUE
cbcbcccadbcdadcdbc	TRUE
cbcddcadcbccbcbcdd	TRUE
cbcddcccdcccdcadcd	TRUE
cccbccbcbcadadadad	TRUE
cccbccdcdcbccadbcd	TRUE
cdbcadbccadcbcccad	TRUE
cdbcadbccbcbcadadd	TRUE
dadadaddbcdbcbcddc	TRUE
dadadaddcadcdcadbc	TRUE
dadcdbcccbccbccbcb	TRUE
dadcdcadcadcbcbcbc	TRUE
dbcbcbcbcbcdbcbcdd	TRUE
dbcbcbcbccadbccadb	TRUE
dcadadbcadadbcdccd	TRUE
dcadadbcadccdaddcd	TRUE
dcccbcddddbcbcddbc	TRUE
dcccccadbcbcdbcdda	TRUE
ddbcbcdbcdadbcdbca	TRUE
ddbcbcdcadaddcdbcc	TRUE
aaaaabaddbbabbcdcc	FALSE
aaaaaccbccdbbaacaa	FALSE
aacbdcdddbccadacaa	FALSE
aacbddaacadccaaaab	FALSE
abbaacdcdddcdaddda	FALSE
abbaadbccddbcadbca	FALSE
abdcabdbbbbbbbbaca	FALSE
abdcacbcdbaccacccb	FALSE
accabddacbccadcddc	FALSE
accabddddbaaccbaad	FALSE
adaccddcadccadcdac	FALSE
adacdabacdaccadbbd	FALSE
addaacbabcbcbadcbd	FALSE
addababadcbcbaabcd	FALSE
babbddbaccbbaaadaa	FALSE
babbddccccdcbdddba	FALSE
badddbababddddcbdc	FALSE
badddbdaabadccdaaa	FALSE
bbcbbdaadaacbdabbc	FALSE
bbcbbdacdccbcddddb	FALSE
bcbaabccccbabdcdac	FALSE
bcbaabcdddddaccccc	FALSE
bcddbaacbdbddadbaa	FALSE
bcddbbcabddadbdacd	FALSE
bdcbaadaadcbdddbac	FALSE
bdcbabbbbcccbddaad	FALSE
caadadabcccbcadcda	FALSE
caadadccdbccbdcbba	FALSE
cadadbbdbdadcdaaac	FALSE
cadadbcdbdcdbdddcd	FALSE
cbbdaacdcddcacbbba	FALSE
cbbdabababcdbaaabd	FALSE
ccabaddbabacaccdad	FALSE
ccabaddbadbaadacca	FALSE
ccdbabadbccdcbbbcc	FALSE
ccdbabbbbcbdbaacbd	FALSE
cdbdadbaaadbaddbda	FALSE
cdbdbaaadcaacbcbdc	FALSE
daabaabbcccdacaddc	FALSE
daabaacdbbacbdabdc	FALSE
dacbdccbcdacdaaabd	FALSE
dacbddcccbbbbbdddd	FALSE
dbbccaccddbbadbcdb	FALSE
dbbccbdcabdcabacab	FALSE
dcacaadbacddbbaddb	FALSE
dcacabadadbdcddbad	FALSE
dcdacbcbabacadcdab	FALSE
dcdaccababdddbaccb	FALSE
ddbbdbabcbccdbcddb	FALSE
ddbbdbbdbcccbccaab	FALSE
adadadadadadadbcada	TRUE
adadadadadadbccbccc	TRUE
adadcbcdadaddddadad	TRUE
adadcbcdbcadadbccbc	TRUE
adbcbcadaddbcbcddbc	TRUE
adbcbcadaddcdcadbcd	TRUE
adbcdcbcbcadbcbcdad	TRUE
adbcdcbccbcbcadbcad	TRUE
adccaddadadccdcddbc	TRUE
adccaddadddbcbcadad	TRUE
addadddbcadbcbcadcc	TRUE
addadddccadddbcbcca	TRUE
adddcbcbccbcbcbcbcb	TRUE
adddcbcccadadbcbccb	TRUE
bcadcadcbcbcbcdaddd	TRUE
bcadcadccdadadcdcbc	TRUE
bcbcadbcdbcadbcdadb	TRUE
bcbcadbcdcadadcadad	TRUE
bcbcdadaddcbcadbccd	TRUE
bcbcdadbcccbcdddadd	TRUE
bccbcbcadadadbcbcca	TRUE
bccbcbcadadbcaddbcd	TRUE
bccdcccddbccdbcdbcb	TRUE
bccdccdcbcddcbcadad	TRUE
bcdcbccadadcdadadbc	TRUE
bcdcbccbcbccdcadbcb	TRUE
cadbcadbcdbcddbcadc	TRUE
cadbcadbcdcdbcadcca	TRUE
caddcadcdddccdcbcdc	TRUE
caddcbcadadccadbcca	TRUE
cbccbcdbccbcdcaddcb	TRUE
cbccbcdccadbcadccbc	TRUE
ccaddcbccccbcadddbc	TRUE
ccaddcbccccdadccbca	TRUE
ccdaddcbccaddadcddb	TRUE
ccdaddccbccbccdbcbc	TRUE
cdbccdadddccdbcbcad	TRUE
cdbccdcaddbccadddcd	TRUE
dadadadbcbcadbcadcb	TRUE
dadadadbcbccbcdbcda	TRUE
dadccdcbccbcadadbcd	TRUE
dadccdccbcbcbcadadb	TRUE
dbcbcbcdbcccdcbcddb	TRUE
dbcbcbcdcdcdadcbcad	TRUE
dcadadbcdbccadbccdd	TRUE
dcadadbcdcdadbcccbc	TRUE
dccdcadbcaddcadadbc	TRUE
dccdcbcbcbcadcbccbc	TRUE
ddbccadcbcddadbcada	TRUE
ddbccaddcadbcadbcad	TRUE
aaaaaaabaacdbcccdac	FALSE
aaaaaabdaacbdaaadbc	FALSE
aacbdddacbdcdbdcbdb	FALSE
aaccaabbacbcbbbadbd	FALSE
abbabaabacdbcbcbacb	FALSE
abbababcaddaddcbaad	FALSE
abdccbadacbddddbcad	FALSE
abdcccaadcabbabbcad	FALSE
accacdcccdacbdcaada	FALSE
accadbdbccbcccadcbd	FALSE
adaddbbabbbaabdbabd	FALSE
adaddbbbaadcadaccdd	FALSE
addcabadbdccbdacbba	FALSE
addcbaccdbdcbccbbcd	FALSE
babddacddddcabaaaab	FALSE
babddbabcccbddbabdc	FALSE
bbaccbbadbcaadaadbb	FALSE
bbaccbcccdbcacdbdda	FALSE
bbcdddcaccbbdbdddcd	FALSE
bbdaaadcbddcbcccdcd	FALSE
bcbbbabbcdcbcadccbc	FALSE
bcbbbacaccdcbcadbda	FALSE
bdaababbcbbcdaaabda	FALSE
bdaabbcbacbdaaacbbc	FALSE
bdccdbdcbbdcaadcdda	FALSE
bdccdcbdccabadbcdaa	FALSE
cabaaabacbacdaacccc	FALSE
cabaaccadcaccabcdcd	FALSE
cadbddaccbabcdcbaad	FALSE
cadbddcdcbdbbacabcc	FALSE
cbcaddacbabacbbabda	FALSE
cbcadddbbbadcaabbdc	FALSE
ccaccccdbacaccdcaaa	FALSE
ccaccccddaadadcdbaa	FALSE
ccdbadcddaddbabbbda	FALSE
ccdbbcdccbaabcdcdcc	FALSE
cdbdaccacbaacbcabcc	FALSE
cdbdadabadccaaadaac	FALSE
daaaaddbcaadadcbaad	FALSE
daaabbaadcadbabbcdd	FALSE
dacbcabccadbccdbbac	FALSE
dacbcbbadcddbdadaaa	FALSE
dbbadbcddcddccadbdd	FALSE
dbbbabacccababcbddb	FALSE
dcaaadabbcdccbccacc	FALSE
dcaaaddaacbcdabadca	FALSE
dccdacbabcacbddadbd	FALSE
dccdadbdcaadbdaddac	FALSE
ddbccabacaadbcdbcba	FALSE
ddbcccaadacbccdbbdd	FALSE
