aaaaaadaca	TRUE
aaaaacbcad	TRUE
aacbdcdcba	TRUE
aacbdcddba	TRUE
aadddcbbbd	TRUE
aadddccadc	TRUE
acbccbcacc	TRUE
acbccbdbad	TRUE
acdcdcacac	TRUE
acdcdcdccb	TRUE
adbcadadbb	TRUE
adbcadccac	TRUE
addbccccac	TRUE
addbcdccbb	TRUE
bacaddcacc	TRUE
bacaddcbbb	TRUE
bbacadddcd	TRUE
bbacaddddc	TRUE
bbccacbbdb	TRUE
bbccacbcbd	TRUE
bcbaaacddc	TRUE
bcbaaddadb	TRUE
bcddcdddcb	TRUE
bcdddaaadc	TRUE
bdcbccbbdd	TRUE
bdcbcdaadb	TRUE
caadbbcbcb	TRUE
caadbbccba	TRUE
cadcccacac	TRUE
cadccdacdc	TRUE
cbcaccbbad	TRUE
cbcacccadc	TRUE
ccacdbaccc	TRUE
ccacdbcccd	TRUE
ccdaddbdbd	TRUE
ccdbaadcac	TRUE
cdbdaadbca	TRUE
cdbdaccccb	TRUE
daaadbaddc	TRUE
daaadcaaac	TRUE
dadbcadbcd	TRUE
dadbcadbdd	TRUE
dbbcbbbcdb	TRUE
dbbcbcdddb	TRUE
dcaaddcadd	TRUE
dcaaddcccd	TRUE
dccdbcbcac	TRUE
dccdbdaaad	TRUE
ddbbbccaaa	TRUE
ddbbbddbcd	TRUE
aaaaaadcab	FALSE
aaaaaccbab	FALSE
aacbddbaab	FALSE
aacbddbabc	FALSE
abbacbacab	FALSE
abbaccdbbb	FALSE
abdcdaaccd	FALSE
abdcdccbdc	FALSE
accaddbdab	FALSE
accaddddab	FALSE
adacddbabb	FALSE
adadabbcad	FALSE
addbcdcdab	FALSE
addbdabbaa	FALSE
babdbbaadd	FALSE
babdbbcdbc	FALSE
bbabbbccac	FALSE
bbabbbcdca	FALSE
bbcdacbcab	FALSE
bbcdacbdab	FALSE
bcbbbbbabb	FALSE
bcbbbbbdab	FALSE
bdaabccddc	FALSE
bdaabcdbac	FALSE
bdccadbcab	FALSE
bdccadbcab	FALSE
cabacbadba	FALSE
cabaccaaca	FALSE
cadcddcbab	FALSE
caddabbaca	FALSE
cbcababbdb	FALSE
cbcabbaadc	FALSE
ccacbaacab	FALSE
ccacbaccab	FALSE
ccdaaabacc	FALSE
ccdaaabdaa	FALSE
cdbcbcbbab	FALSE
cdbcbcbcab	FALSE
daabacabca	FALSE
daabacdbac	FALSE
dacddabaad	FALSE
dacddbbdab	FALSE
dbbdabbdcb	FALSE
dbbdacdabd	FALSE
dcaacdbdab	FALSE
dcaacdbdab	FALSE
dccccdcdab	FALSE
dccccdcdab	FALSE
ddbadbbdab	FALSE
ddbadcadab	FALSE
aaaaaadacad	TRUE
aaaaacbadaa	TRUE
aaccbcdbcdc	TRUE
aaccbdadacc	TRUE
aaddddbaaca	TRUE
aadddddbbad	TRUE
acbdbaacdca	TRUE
acbdbadaacd	TRUE
acddaaddbcb	TRUE
acddaadddac	TRUE
adbccccdcdb	TRUE
adbccdbbdcd	TRUE
addbdcacacd	TRUE
addbddbccba	TRUE
bacbadaacbc	TRUE
bacbadacbbb	TRUE
bbaaadcbccc	TRUE
bbaaadccbca	TRUE
bbccbddaccb	TRUE
bbcccacbbad	TRUE
bcbaddbaccd	TRUE
bcbaddbdcbd	TRUE
bcdcbdbdddc	TRUE
bcdccacbdad	TRUE
bdcbccaacbd	TRUE
bdcbdaccbaa	TRUE
caadbddcbbc	TRUE
caadcacbaad	TRUE
cadcdbcdcdd	TRUE
cadcdbdcdbc	TRUE
cbbdccaccba	TRUE
cbbdccadbcd	TRUE
ccaadbccdca	TRUE
ccaadcacacb	TRUE
ccdacbaadbb	TRUE
ccdacbccaac	TRUE
cdbdaddadaa	TRUE
cdbdaddcaad	TRUE
daaadbdadad	TRUE
daaadcaaaaa	TRUE
dadacbbcbcc	TRUE
dadacbccbba	TRUE
dbbcaddcbcc	TRUE
dbbcbaccdbc	TRUE
dcaacadcbdc	TRUE
dcaacaddbdd	TRUE
dccdaccdbac	TRUE
dccdadbdacc	TRUE
ddbbbadaddb	TRUE
ddbbbcacdaa	TRUE
aaaaaadbdab	FALSE
aaaaabacabd	FALSE
aacbdddaabc	FALSE
aaccaaaadab	FALSE
abaddcbddad	FALSE
abbaacaabcb	FALSE
acaabbcbaad	FALSE
acaabcaabdd	FALSE
acccccabbdb	FALSE
acccccddcab	FALSE
adbbbaabddc	FALSE
adbbbacccab	FALSE
adddacdabbc	FALSE
adddadbbcab	FALSE
baccaacbdab	FALSE
baccabdaabd	FALSE
bbbadbacbab	FALSE
bbbadbaccab	FALSE
bbdccbcacab	FALSE
bbdccbdbcab	FALSE
bccadadddab	FALSE
bccadbddcab	FALSE
bdadbdbbcab	FALSE
bdadbdbdaab	FALSE
bddbcbbcdab	FALSE
bddbcbcbcab	FALSE
cabdabddacc	FALSE
cabdadacadc	FALSE
cbacaacbcab	FALSE
cbacaaccaab	FALSE
cbdaacccaab	FALSE
cbdaaccddab	FALSE
ccbcbbabdad	FALSE
ccbcbbabdcc	FALSE
cdaabcbbaad	FALSE
cdaabcdacdb	FALSE
cdccdaabaac	FALSE
cdccdcbccab	FALSE
dabbadadbab	FALSE
dabbadbbbab	FALSE
daddbcbcdab	FALSE
daddbcdacab	FALSE
dbcadbdabac	FALSE
dbcadbdddab	FALSE
dcacbaaacab	FALSE
dcacbaadcab	FALSE
dccdbabacca	FALSE
dccdbacacab	FALSE
ddbbdadcbab	FALSE
ddbbdcaddab	FALSE
aaaaaaaccadc	TRUE
aaaaaaacddac	TRUE
aacbdbcadbba	TRUE
aacbdbdaddbb	TRUE
aaddcbcaaaad	TRUE
aaddcbddbadc	TRUE
acbdaddccbda	TRUE
acbdbaacdcca	TRUE
acdddadacbda	TRUE
acdddbadcbaa	TRUE
adbddccddadb	TRUE
adbdddaacbcd	TRUE
adddbaddbbac	TRUE
adddbbbbdcdb	TRUE
bacdbcdadbca	TRUE
bacdbdaaccdd	TRUE
bbadddccbdcd	TRUE
bbadddcdcbaa	TRUE
bbdbcaaccaca	TRUE
bbdbcaacddbc	TRUE
bcbddcaaddad	TRUE
bcbddcacccdc	TRUE
bdacaacbdcbd	TRUE
bdacaaccbbdd	TRUE
bddacbcdbadb	TRUE
bddacdaaacda	TRUE
cacbcbddbdbd	TRUE
cacbccdadbda	TRUE
cbacbcbaccac	TRUE
cbacbdadacca	TRUE
cbcdbdddcccc	TRUE
cbcdcacdbcca	TRUE
ccbbbdcdddbb	TRUE
ccbbcccacdca	TRUE
cdaadacccbca	TRUE
cdaadadacaad	TRUE
cdcdaaaccacd	TRUE
cdcdaacacadb	TRUE
daaddadadccb	TRUE
daaddbbbcadb	TRUE
daddaddccdba	TRUE
daddadddddac	TRUE
dbcbaadbddcd	TRUE
dbcbacbcdbdb	TRUE
dcacbbbacddc	TRUE
dcacbbbdbddd	TRUE
dccddbdacaca	TRUE
dccddbddacda	TRUE
ddbadddbbbcc	TRUE
ddbbaaadbcac	TRUE
aaaaaadbdaab	FALSE
aaaaabcabdac	FALSE
aacbdbcbcdab	FALSE
aacbdbccbdab	FALSE
abbbacaabaaa	FALSE
abbbacbbcdbd	FALSE
acaabcbbdbcb	FALSE
acaacaadcbab	FALSE
accccbbdadab	FALSE
accccbcccdab	FALSE
adbbccaadcab	FALSE
adbbcccccaab	FALSE
adddbcbabccd	FALSE
adddbcbdcaab	FALSE
bacabdcbabda	FALSE
bacacacabcdd	FALSE
bbacaddbadab	FALSE
bbacaddccbab	FALSE
bbcddcccccab	FALSE
bbcdddccadab	FALSE
bcbdaaccdbab	FALSE
bcbdadbaacab	FALSE
bdaccdcbbdab	FALSE
bdaccdcbccab	FALSE
bddadadbcaba	FALSE
bddadbbabdcc	FALSE
cacadaabbabd	FALSE
cacadbcccabd	FALSE
cbaccbcababb	FALSE
cbaccbcbcbab	FALSE
cbdbbaccbdab	FALSE
cbdbbcbcbbab	FALSE
ccbcdcdbcabb	FALSE
ccbcddadddab	FALSE
cdabbbaababc	FALSE
cdabbbbbcacb	FALSE
cdcdcacbdcab	FALSE
cdcdcbbdcbab	FALSE
dabbcdcaabdd	FALSE
dabbcddbaacc	FALSE
daddbdcbdcab	FALSE
daddcabdbbad	FALSE
dbcbbdaadaab	FALSE
dbcbcaabcacc	FALSE
dcaccabaddac	FALSE
dcaccbababba	FALSE
dcdacdcaacab	FALSE
dcdadaacbaab	FALSE
ddbccbcadbab	FALSE
ddbccccdacab	FALSE
aaaaaaaacbcac	TRUE
aaaaaaaacdbad	TRUE
aacbdcacbcbda	TRUE
aacbdcbaadaaa	TRUE
aaddadcaccccb	TRUE
aaddaddddaaca	TRUE
acbdbcaacbdba	TRUE
acbdbcacccdad	TRUE
acdcadaadaadb	TRUE
acdcadcacaadd	TRUE
adbbbbddcdcbd	TRUE
adbbbdcacaccb	TRUE
addbaccaacaaa	TRUE
addbacdcdaccb	TRUE
bacadcbbbcdcc	TRUE
bacadcdadbadc	TRUE
bbacacbaaccaa	TRUE
bbacaccdadbcc	TRUE
bbcddacbbcdaa	TRUE
bbcddcaaacbdc	TRUE
bcbbdbaacbccc	TRUE
bcbbdbccbdddd	TRUE
bdaaadadbbbbc	TRUE
bdaaadcdacdaa	TRUE
bdcbdacbacaad	TRUE
bdcbdaddaaadc	TRUE
caacccbadcacc	TRUE
caacccbbbdbad	TRUE
cadbdbcbbaccc	TRUE
cadbdccddcdad	TRUE
cbbddbbbdadbc	TRUE
cbbddbdacacda	TRUE
ccacdaddbcacd	TRUE
ccacdadddbdda	TRUE
ccdaadcadcbda	TRUE
ccdacaddcbbdb	TRUE
cdbccbacbcdcb	TRUE
cdbcccbbacdcd	TRUE
daaacccbccdaa	TRUE
daaacdaaaadaa	TRUE
dadadbcaccaad	TRUE
dadaddacbcbac	TRUE
dbbcbcbbbcdca	TRUE
dbbccadbadcdb	TRUE
dcaaccacadcaa	TRUE
dcaaccbacbdad	TRUE
dccbdbccaaadd	TRUE
dccbddddbcccb	TRUE
ddbadbacccadc	TRUE
ddbadcaddbada	TRUE
aaaaaaddacbab	FALSE
aaaaabcdbcacb	FALSE
aacbcdaabcaab	FALSE
aacbdbcbbbcab	FALSE
abbacacbbccdb	FALSE
abbacadbbcbdc	FALSE
abdccabccabbc	FALSE
abdccaccacbac	FALSE
accaabdadddda	FALSE
accaacbdcbaab	FALSE
adaccbbacaabc	FALSE
adaccbbbacdab	FALSE
adcdddadcddab	FALSE
addaabcaabbbb	FALSE
babdcbccdbbac	FALSE
babdcddabddad	FALSE
bbacbadbaaaab	FALSE
bbacbbddaaaab	FALSE
bbdaccbadddab	FALSE
bbdaccddddcab	FALSE
bcbbcadadcaba	FALSE
bcbbcbbccccab	FALSE
bcddcdacaccab	FALSE
bcdddaabdaacd	FALSE
bdcbbaacadcab	FALSE
bdcbbabcbddcd	FALSE
caadabcdcdaca	FALSE
caadabdbcacac	FALSE
cadccabcdbccd	FALSE
cadccacbcdcab	FALSE
cbcbddacbdaab	FALSE
cbcbddbacdaba	FALSE
ccbaadccdccab	FALSE
ccbabbdbbcabd	FALSE
ccdbccdddadab	FALSE
ccdbdadbcccab	FALSE
cdbdbacaddabd	FALSE
cdbdbbbadbdab	FALSE
daaadbacdcbab	FALSE
daaadbcbbdcab	FALSE
dacdadcaaddab	FALSE
dacdbaadbbdab	FALSE
dbbbabaccdbca	FALSE
dbbbabcaacddc	FALSE
dbddcbdabbadc	FALSE
dbddccaadbcab	FALSE
dcccdaccddbab	FALSE
dcccdadcdaaab	FALSE
ddbcbbaadacab	FALSE
ddbcbbacdcbab	FALSE
aaaaaaaacbcacb	TRUE
aaaaaaaacdadba	TRUE
aacbdaacdaadad	TRUE
aacbdaadbadddc	TRUE
aaddcbcbcccacb	TRUE
aaddcbdaccdcac	TRUE
acbccaaddbaadb	TRUE
acbccbadddacca	TRUE
acdcaadbcddaac	TRUE
acdcacadddcbca	TRUE
adbbcacaadbadd	TRUE
adbbcaccbddccd	TRUE
addbbbdbccdddc	TRUE
addbbcccaadbbc	TRUE
bacaadadacdcdc	TRUE
bacaadcbaaacbd	TRUE
baddcdccdccbdc	TRUE
baddcddadcaada	TRUE
bbcbbdcddbbcbc	TRUE
bbcbcaacdbccdd	TRUE
bcbacdcbacbdcd	TRUE
bcbacdccbdccac	TRUE
bcddaaacdcbddc	TRUE
bcddaacbdadcdc	TRUE
bdcadacdaccacb	TRUE
bdcadbbadadbdd	TRUE
caacdbbbcbbacc	TRUE
caacdbbcadbddd	TRUE
cadccbadbdccdd	TRUE
cadccbdaadaccb	TRUE
cbbdbdcaaaadbd	TRUE
cbbdbdccdadcda	TRUE
ccaacdddbdadca	TRUE
ccaadbaadadada	TRUE
cccdcacbaaddaa	TRUE
cccdccddcacdac	TRUE
cdbcaaddaacdcb	TRUE
cdbcacaaacdaad	TRUE
daaacbbbadaadd	TRUE
daaacbbcccbada	TRUE
dadacdaccacadb	TRUE
dadacdaddadacb	TRUE
dbbcbbacbbacaa	TRUE
dbbcbbdbcbbbba	TRUE
dcaadcdbdacddb	TRUE
dcaadcdcbbaada	TRUE
dcdaaddbacadbd	TRUE
dcdacaacbbcadc	TRUE
ddbbcbbddadadb	TRUE
ddbbccacdaaacb	TRUE
aaaaaaccaaadab	FALSE
aaaaabaddacbad	FALSE
aaccbddabdddab	FALSE
aacccadcdcbabc	FALSE
abaddbdccdcddd	FALSE
abaddcdadabaab	FALSE
abdbdcddbabbba	FALSE
abdbddbaacbdbd	FALSE
accabdabbdbdad	FALSE
accacbdaccdbab	FALSE
adadcadcdacbab	FALSE
adadcbacaddabd	FALSE
addbaacdcbdcab	FALSE
addbaadddbbbab	FALSE
bacaabbbccdbac	FALSE
bacaacaaaddcab	FALSE
bbacccabbbbaba	FALSE
bbacccacacbbab	FALSE
bbdbbdaddbddab	FALSE
bbdbbddbdddabd	FALSE
bcbdaddbcaacab	FALSE
bcbdbacaaaacab	FALSE
bdabbbaacaaabc	FALSE
bdabbbabbdccbc	FALSE
bdcdddddaadabd	FALSE
bddaabbbbddbad	FALSE
cabbbbdaacbdcc	FALSE
cabbbcacccbcbb	FALSE
caddcadaacdbab	FALSE
caddcbacccabac	FALSE
cbcbcbccbdddab	FALSE
cbcbccbdabbdbd	FALSE
ccbaadbbabaabd	FALSE
ccbaaddbcbdcab	FALSE
ccdbccaccaadab	FALSE
ccdbcccaddadab	FALSE
cdbdcdbdbdbaab	FALSE
cdbdcdbddcccab	FALSE
daacbdbbbbddab	FALSE
daacbdbcabdabc	FALSE
dadaadbabccdaa	FALSE
dadaadcdcabbdd	FALSE
dbbcbdbabccccd	FALSE
dbbcbddddbacab	FALSE
dcaaabbcbabbbd	FALSE
dcaaacdbcbabbc	FALSE
dccdacdbdadbab	FALSE
dccdbadbadcdab	FALSE
ddbbacbdabcbcd	FALSE
ddbbadacbcaabb	FALSE
aaaaaaacbbcbbbb	TRUE
aaaaaaaccdaddbd	TRUE
aacbbdbdaaaaacc	TRUE
aacbbdddddbdadd	TRUE
aadcddadbacadbb	TRUE
aaddaaccddcdccd	TRUE
acbcccaaacacdcb	TRUE
acbcccaccbdaacb	TRUE
acdbdbaadbbccad	TRUE
acdbddbdccaaccc	TRUE
adbbcadbaadccca	TRUE
adbbcadcadcbccc	TRUE
addbbbdacdbddba	TRUE
addbbcbdcadbacd	TRUE
bacbccbcdddadad	TRUE
bacbcccadbacddb	TRUE
bbacacdadadbacc	TRUE
bbacadacdbbaccd	TRUE
bbcddbcadacdbcb	TRUE
bbcdddacdbaadca	TRUE
bcbbcddaaadaaaa	TRUE
bcbbdacdcccaccc	TRUE
bdaacbbcacbbaaa	TRUE
bdaaccbdcbacccb	TRUE
bdcdbacaaccccdb	TRUE
bdcdbbcbccbacac	TRUE
cacaaadaccbdbac	TRUE
cacaaaddcadaada	TRUE
cbaacbbbcbbcbcc	TRUE
cbaacbcaacadddd	TRUE
cbdaaacbbdccada	TRUE
cbdaaacddacdcac	TRUE
ccbcbaaacbaaacc	TRUE
ccbcbadaddbbaac	TRUE
ccdccbbddadaaac	TRUE
ccdcccddadddcbd	TRUE
cdcaadccdbdbcac	TRUE
cdcaaddbbacbccb	TRUE
daacadbdbbdccad	TRUE
daacadcaaadbdcb	TRUE
dadbbcbcacadccb	TRUE
dadbbccacdaacca	TRUE
dbbcbadacbddbbb	TRUE
dbbcbbaadbadcbc	TRUE
dcaadccbcaaacbb	TRUE
dcaadcdddcccddb	TRUE
dccddaadaadacbd	TRUE
dccddaadacaaacc	TRUE
ddbbadbadcdbbdd	TRUE
ddbbadcbbddcbba	TRUE
aaaaaaaaacaabcc	FALSE
aaaaaaabaccbada	FALSE
aacaddcabacbcda	FALSE
aacbaacdabcbdba	FALSE
abadccaabddcbbb	FALSE
abadccaadbbbcad	FALSE
abdcccaccccbdcd	FALSE
abdcccbdabacbab	FALSE
accabcabadadcdb	FALSE
accabdcdbbdbddc	FALSE
adabccdcbdaccab	FALSE
adabcdadbbcadda	FALSE
addaadbddababbb	FALSE
addaaddddccabcc	FALSE
babdacacabadddd	FALSE
babdadabbbddcbd	FALSE
bbabbcbadacbccc	FALSE
bbabcababbaddbc	FALSE
bbcdaabaccadddd	FALSE
bbcdabaadcbcdbb	FALSE
bcbabdddcccccad	FALSE
bcbacaaaaabbdca	FALSE
bcdcbcbcbaadcab	FALSE
bcdcbcdaaabcddc	FALSE
bdcbcabbcabdcdd	FALSE
bdcbcbbccccaabd	FALSE
caaddcabccadaca	FALSE
caadddbbcbaacab	FALSE
cadbbbccacdcabd	FALSE
cadbbddbbdbaaab	FALSE
cbbdbaababbadca	FALSE
cbbdbaacacadbab	FALSE
ccacadbbadbcbab	FALSE
ccacaddbbbdadab	FALSE
ccdaacdbdacbcab	FALSE
ccdaadababdbbac	FALSE
cdbdcdabdacdcca	FALSE
cdcaadacadababd	FALSE
daadcbbadcaacab	FALSE
daadcbcaadbddab	FALSE
dadbbdcbaccccab	FALSE
dadbcabadacdabc	FALSE
dbbdaadcababdaa	FALSE
dbbdabdcbbaddcb	FALSE
dcaacacbdacbcab	FALSE
dcaacbcdaababbd	FALSE
dcdaaccabadbbca	FALSE
dcdaaccbcbbabba	FALSE
ddbbdcbcbcbdcab	FALSE
ddbbddbddbdcabc	FALSE
aaaaaadacdccbbac	TRUE
aaaaaadbbbacacdd	TRUE
aacbdaadcadbdbbd	TRUE
aacbdaccdbcddbbb	TRUE
aadcdadbbbcdbbba	TRUE
aadcdadbcdadcbdb	TRUE
acbcbcbdaaaddccd	TRUE
acbcbdbbbcddbbaa	TRUE
acdbcbbacddaccbd	TRUE
acdbcbcbdbaacadc	TRUE
adbcaacdacddbbcc	TRUE
adbcaacdccdaaddd	TRUE
addbcccdddbbccba	TRUE
addbcdbdaaacbbcd	TRUE
bacacacadaddaadd	TRUE
bacacadaccddaccb	TRUE
bbaacaacdcdadbca	TRUE
bbaacaddacaadbbc	TRUE
bbccbacbbccccaca	TRUE
bbccbcadcaacaacc	TRUE
bcbbbbaaacaacbba	TRUE
bcbbbbbaaaadacac	TRUE
bcddddacbadbcadc	TRUE
bcddddcbbbcdacbb	TRUE
bdccacccdbbcaadb	TRUE
bdccadbacadaacdd	TRUE
caacddbddbadcbcd	TRUE
caadacbbdaacaadc	TRUE
cadcccbaacbbadda	TRUE
cadccccadcdacdca	TRUE
cbcbbbacaddcaddb	TRUE
cbcbbbadaccdddcb	TRUE
ccadbdadbacdcdac	TRUE
ccadbdbadccdaaac	TRUE
ccdbbbadddccdcdb	TRUE
ccdbbbbbdddddbaa	TRUE
cdbddaaadbcdcbcd	TRUE
cdbddadbaacaaccc	TRUE
daaccbdbbbacaadd	TRUE
daaccbdbbdddbcbb	TRUE
dadbacbadcddddbd	TRUE
dadbaccdbbbcbdcd	TRUE
dbbcbbbbdbdadacd	TRUE
dbbcbbdddacbdddb	TRUE
dcaaaacdbbdbbada	TRUE
dcaaacaacdbcbaad	TRUE
dccdcddadaacdbaa	TRUE
dccddbbbbcbcbaac	TRUE
ddbcaccdcbacddcd	TRUE
ddbcadbcdbbaddda	TRUE
aaaaadbcdadcaabd	FALSE
aaaabccddbccdbaa	FALSE
aacdaadaabdacccc	FALSE
aacdbadcbbacbaba	FALSE
abbacacbcddacaac	FALSE
abbacadbaacaadcd	FALSE
abdcdbcadccacbad	FALSE
abdcdbdbdccadacb	FALSE
accacabcabbcbaca	FALSE
accacadabcaadddb	FALSE
adbaabacdbabcbac	FALSE
adbaaccadddaadab	FALSE
addbbabdcdcacbcd	FALSE
addbbacbaacbbabb	FALSE
babdcbaadabbdbaa	FALSE
babdcbbaccdbaadc	FALSE
bbabbddbdcccdbdc	FALSE
bbabcaddabbadbdc	FALSE
bbcdcadbabcaacad	FALSE
bbcdcbbdccbdabab	FALSE
bcbbdcbdbbabdbac	FALSE
bcbcaacbadddbabd	FALSE
bdababcacdbaacad	FALSE
bdabbcaaabadddda	FALSE
bdcdaabdabbcaccd	FALSE
bdcdabbacbcdaabc	FALSE
cabadacaccccabba	FALSE
cabadbbdcdcbbcdb	FALSE
caddcadbcaddaaab	FALSE
caddcbccbdcdddab	FALSE
cbcbdcacbabdccaa	FALSE
cbcbdcdccaadbcab	FALSE
ccadaccbdacaabda	FALSE
ccadadbbacdaccab	FALSE
ccdbcccaddaaacab	FALSE
ccdbcccbbbddaaab	FALSE
cdbdcccdbddbaaba	FALSE
cdbddabcaaabbcab	FALSE
daabcacdbaaabbdb	FALSE
daabcbabaaadabcb	FALSE
dacdacccaacbadab	FALSE
dacdadbbcabbaabc	FALSE
dbbbcdabbcbadccb	FALSE
dbbbcdabddbadada	FALSE
dcaaabcabbcdbbcc	FALSE
dcaaabcadacacbaa	FALSE
dccccbbbabbabddc	FALSE
dccccdaabaadbdab	FALSE
ddbbbbadcabdbbcc	FALSE
ddbbbbdbbddcddab	FALSE
aaaaaaaacbccccbdd	TRUE
aaaaaacdcacbaacba	TRUE
aacbdcdaaaadbaadd	TRUE
aacbddbaccbaddbdb	TRUE
aaddddccdaddcbbdb	TRUE
acaaaaaacadcdcbad	TRUE
acbdbcaacaddbdbaa	TRUE
acbdbcdaacacbcdcd	TRUE
acdccdaaadbacaaac	TRUE
acdccdadcbbacadcd	TRUE
adbccbddccaacbdda	TRUE
adbccccaacaccdcca	TRUE
addcbaaaacdacdccd	TRUE
addcbdcbbbcdcddbd	TRUE
baccbacadaadbaaad	TRUE
baccbacccdddbdada	TRUE
bbacaaccdaacdadbd	TRUE
bbacacaccbacacddc	TRUE
bbdacdbdcacbcdbbd	TRUE
bbdacddadddbbbcda	TRUE
bcbccbaddadcaacaa	TRUE
bcbccbbccaccbcbbb	TRUE
bdaaaaaadbcdbcdcd	TRUE
bdaaaacaaccdbaaad	TRUE
bdcccaacadcbdaacb	TRUE
bdcccadcdadddcccc	TRUE
caadbbdcaadbadcbd	TRUE
caadbcaddacbbdbac	TRUE
cadcaacddcbaddacb	TRUE
cadcacaaaaadaacad	TRUE
cbbdbddaaddbaccca	TRUE
cbbdbddacdaaaaaac	TRUE
ccacbaccdcdcbdbdc	TRUE
ccacbaddbdcbaccad	TRUE
cccdddbdadaacddac	TRUE
ccdaaaadbdbcdcdcd	TRUE
cdbccdbadcdaaccda	TRUE
cdbcdcbadacaccddd	TRUE
daaadadcdccaadcdd	TRUE
daaadbbbcadcccaad	TRUE
dadaccbdbcaccbcdb	TRUE
dadacddadbddaccda	TRUE
dbbbccdccbbaaaadd	TRUE
dbbbdaadacdadaacc	TRUE
dcaaaadcdbbdcdcba	TRUE
dcaaadaacdddaddaa	TRUE
dccdbadaaaaaaddad	TRUE
dccdbadacbdcbdaac	TRUE
ddbcbbcaacbddadad	TRUE
ddbcbbccadaaccdbd	TRUE
aaaaaaccdcabccabd	FALSE
aaaaabaccbcadbadc	FALSE
aacbcbbadddbabcca	FALSE
aacbcbbcdbbabbcab	FALSE
abacdbbdabcdaabbb	FALSE
abacdcbccadaccdac	FALSE
abdadbbcbadacacdc	FALSE
abdadbddadadaabaa	FALSE
acbdaacbabddbccac	FALSE
acbdaacbdacaaddab	FALSE
adaabdbcccabcbbad	FALSE
adaacababdcbacaad	FALSE
adcdccdddabadbbbc	FALSE
adcdcdbbbadbabaab	FALSE
babbcacdadacabadb	FALSE
babbccbcbcabbbcab	FALSE
bbaaaacacaddabcca	FALSE
bbaabaaadacccdddd	FALSE
bbcbdaabbabbcbcda	FALSE
bbcbdccbbbbbcaaab	FALSE
bcbacabdcaabadcbd	FALSE
bcbacbbbbcacabdaa	FALSE
bcddaabcddcadddca	FALSE
bcddabaadcdddcccb	FALSE
bdcadbadacbcbddab	FALSE
bdcadcbacbacdaaba	FALSE
caadabbcbacabdaba	FALSE
caadabdabcbadbbbb	FALSE
cadbcbbabbdadddbd	FALSE
cadbcbdaaaacbabbd	FALSE
cbcaabbccdbbbdaac	FALSE
cbcaabdacabaaccba	FALSE
ccabdbbcdddbccddc	FALSE
ccabdcadbbaabccbd	FALSE
ccccccacbbcdbadab	FALSE
cccccccdcbcaaaaab	FALSE
cdbacbdacbbbcdcab	FALSE
cdbaccbdaccaacabc	FALSE
cdddcddaccaaaddab	FALSE
cddddbbbcabcdcbda	FALSE
dacbdcbbcbcbadabc	FALSE
dacbdcdaabdcccddc	FALSE
dbbacadbacdcdcdab	FALSE
dbbacbdcbdccbdcab	FALSE
dbddbcabaabcdabba	FALSE
dbddbccdbcbbadbab	FALSE
dcccddbcddbbdabdc	FALSE
dcccddbdadacdcabb	FALSE
ddbbcbcddaacdadab	FALSE
ddbbcbddbccbbabcb	FALSE
aaaaaacbaddcacadca	TRUE
aaaaaacddadcccdbad	TRUE
aacbbcbadacdcbadaa	TRUE
aacbbcdbbddadaccad	TRUE
aadcdaccbacbadddca	TRUE
aadcdadbdcddbcdaad	TRUE
acbcaaacbbccdbcccd	TRUE
acbcaadbddbcaacddc	TRUE
acdbadddaaccdcddac	TRUE
acdbbaaaaaddbbaadd	TRUE
adbbadaaaaddadbcbc	TRUE
adbbadbaccbcaaacad	TRUE
addaacacbaaaaacdbc	TRUE
addaacadaadcacbdca	TRUE
baadaddcadcacdcacd	TRUE
baadbaaccdbdbadbbc	TRUE
badcdbaacdbaddccba	TRUE
badcdcacccdcdadcad	TRUE
bbcaacacaddddcdbac	TRUE
bbcaadbccbcaccacda	TRUE
bcadcbaddacbbadbba	TRUE
bcadcbadddcdbbcacb	TRUE
bcdbbadbdcdaadacdb	TRUE
bcdbbbdbcdadcbdbbd	TRUE
bdcaacadadbcbddccb	TRUE
bdcaadacbaacccbacc	TRUE
caacacdbdadbdaadcd	TRUE
caacadccbaadaaddba	TRUE
cadbccdaaadccbaccc	TRUE
cadbccdbdbcdbdadad	TRUE
cbbccaddbaacdbcdca	TRUE
cbbccdaaaccadbbdcd	TRUE
ccaaaacaccbcdaacac	TRUE
ccaaaadbdbccbdacdd	TRUE
cccccdcbbcbddacdbb	TRUE
cccccdccccccbbaaaa	TRUE
cdbadccbcaacbaaccc	TRUE
cdbaddbcbddadadcbc	TRUE
cdddcdaadacddcccdc	TRUE
cdddcdbadbacdbdbda	TRUE
dadaaaaacddbbddaca	TRUE
dadaaaaccdbcdaaadc	TRUE
dbbbadbbbacadadadc	TRUE
dbbbbaaaddaddcaaca	TRUE
dcaaadbccbdbacacdb	TRUE
dcaaadcbdaadaacdcc	TRUE
dccdaccdbadccbccca	TRUE
dccdbcaaaccaaacaac	TRUE
ddbbcbcaadacccccbd	TRUE
ddbbcbcbdbcbdaadda	TRUE
aaaaaacabbbcddcdcd	FALSE
aaaaacacbacbbbbbab	FALSE
aaccaddcdbcbbbbbab	FALSE
aaccbaaacccbdababa	FALSE
abadccbbddcadbadbc	FALSE
abadccdccbbabcbadc	FALSE
abdbcbccbdbabcdccb	FALSE
abdbcbdddabcbadcac	FALSE
acbdbddacccbdaadab	FALSE
acbdbddcacdcbbacab	FALSE
adaaccddbaacaadbab	FALSE
adaacdbaaddbbdbcab	FALSE
adccbbabbccacbcbcd	FALSE
adccbcbbccbdbcccab	FALSE
baaddaadacdddacbab	FALSE
baaddabbcdbddbaaad	FALSE
baddaabdcbcacbdddd	FALSE
baddabadabaddadacb	FALSE
bbcabbdccaabdddbac	FALSE
bbcabdddcbabdddaca	FALSE
bcbaaabacdddcbbdcd	FALSE
bcbaaaccabdbcdbbab	FALSE
bcdbbaddbaaadcaabb	FALSE
bcdbbbcdbcccbcccab	FALSE
bdcaaccdccacbbcbab	FALSE
bdcaadcbaabaaaaaaa	FALSE
caacccdacddbbcbcab	FALSE
caaccdbdbcaaadbdab	FALSE
cadacaadcabcdcbdac	FALSE
cadacabbdccbdbdbcc	FALSE
cbbbcaacadbacaadab	FALSE
cbbbcacdbcdbacbbab	FALSE
ccaaabbbdccabddbba	FALSE
ccaaabcaabcbdaaccc	FALSE
cccbdccadadcbcbdab	FALSE
cccbdcdcaddccbbdab	FALSE
cdbaccddacbabbcdbb	FALSE
cdbacdcaddbbdcbbab	FALSE
cdddbdaabadcbacacc	FALSE
cdddbdbbbddbacacab	FALSE
daccbaccbbaabbcdbb	FALSE
daccbdaadbddcccaab	FALSE
dbbadaabccbbdcbaac	FALSE
dbbbaadabbcabddcad	FALSE
dcaabccbaabdbbdadd	FALSE
dcaabdaabdadbcdbbd	FALSE
dcccabadddcddbdaad	FALSE
dcccabdabdbdcbcdcd	FALSE
ddbaadbccbacccbbab	FALSE
ddbaadcbbbaadaacab	FALSE
aaaaaaaccddcbcadbaa	TRUE
aaaaaacdbccbbcaadcb	TRUE
aacbcccbcbcdbdaaadc	TRUE
aacbccdcbdadccdddad	TRUE
aaddbbdbdbcddbccacd	TRUE
aaddbbdbdcbddaaacba	TRUE
acbcddacaddbccccaaa	TRUE
acbdaaadaaacacbaadd	TRUE
acdcdbbacdbddaddaad	TRUE
acdcdcadadbdbdadbac	TRUE
adbcaadadcdcbddddda	TRUE
adbcacbcddcddbdbbdc	TRUE
addbcdaaccadddcdcac	TRUE
addbcdccaddcadaccbb	TRUE
baccbbadadcbbdadcdd	TRUE
baccbbadbccdbbbbacb	TRUE
bbadadaaddbaaadccac	TRUE
bbadadccddbaddbdbac	TRUE
bbdbbbacccbdadbdaac	TRUE
bbdbbbbadbacbcdcbbc	TRUE
bcbdaaccdcaaadcdddd	TRUE
bcbdadaadcbbdbadcca	TRUE
bcdddacbcddcccdaadc	TRUE
bcdddbbcacdbbacbcba	TRUE
bdcdbacbcbcdaadccdb	TRUE
bdcdbadbccdbdaccccd	TRUE
cacacdccacadbadcbda	TRUE
cacacddbccbbcbbccca	TRUE
cbacaaadcddaadadadc	TRUE
cbacacadcbdbaaccbdd	TRUE
cbcdadcacdccadcdcad	TRUE
cbcdaddcbcaaddaddba	TRUE
ccbbbadcadbaadaaaaa	TRUE
ccbbbbacbadbbbcbbac	TRUE
cdaaacbddbccadbaadc	TRUE
cdaaaccbcccbdbcaddd	TRUE
cdcdaaadcdcbacbaaaa	TRUE
cdcdaadadbbdcdddbbd	TRUE
daadadacdaaaadaaaaa	TRUE
daadadbdccdbcdacacc	TRUE
dadcccbcbbbadbdaadd	TRUE
dadccdcadbbaacadddb	TRUE
dbcaaadacdcbbaaacbc	TRUE
dbcaaadddcbdcbdadaa	TRUE
dcadbacbadcaaacdaaa	TRUE
dcadbacdcaacacbddad	TRUE
dcdaddbacadbdddcbcd	TRUE
dcdadddccbbcdbbbada	TRUE
ddbcdbbcdcccaaddbac	TRUE
ddbcdbcacbaacacbadb	TRUE
aaaaaaacacdcdcdbbab	FALSE
aaaaabaddcdbdcdcacb	FALSE
aaccaabcadbccababdb	FALSE
aaccaacaadcbcbcbaba	FALSE
abbabcddbaccdccacab	FALSE
abbabdcaacabdaddbcb	FALSE
abddabdcabcadbdabad	FALSE
abddadccddbabdbacbc	FALSE
accbacdbcdcbbddaaba	FALSE
accbbaabdaddcbaddba	FALSE
adadacacbaadaadbbab	FALSE
adadacbabaabadccbda	FALSE
addbacaccbccadbbcab	FALSE
addbacbdcadddbbbbab	FALSE
babdcbdaabcdddcbbcd	FALSE
babdcdcbcacacbabdda	FALSE
bbacaadadbbaacdccab	FALSE
bbacabaacaddcdbdcdd	FALSE
bbdbaadcbdaaabaadca	FALSE
bbdbabdcabaadbbddaa	FALSE
bcbddddbcdbdaccbbab	FALSE
bccaabbabdabccaaaaa	FALSE
bdabdbadcbbacbdbbcd	FALSE
bdabddadddacbdaaacd	FALSE
bddabcaacbacadbdcbb	FALSE
bddabcbacdabbcdaaad	FALSE
cabccbdbcbabacaabdc	FALSE
cabcdbcbcadadbacabc	FALSE
cbaabdcccabbddbadcb	FALSE
cbaacaaadbadbcacdab	FALSE
cbcdaddacadcdcbbbab	FALSE
cbcdbbcddcdaaddacab	FALSE
ccbbddadbaccddbbbab	FALSE
ccbbddbdbbcdabddabd	FALSE
cdaaaddaddbbccadbab	FALSE
cdaababdddaddcacbbc	FALSE
cdcbddbddcaccdbbabd	FALSE
cdccaabacaccccabcba	FALSE
dabadbacabcbdbbdacd	FALSE
dabadcaabdcccdbcdbb	FALSE
daddadbbccdbbaddbab	FALSE
daddadbdcaddacddbab	FALSE
dbcababddcccccbdaad	FALSE
dbcabaddabdaddcdbcb	FALSE
dcabdbbdbbbbcccdbbc	FALSE
dcabdbdbbbdccbadbbc	FALSE
dccdaccbbccddcaabdb	FALSE
dccdaccccdaadacdabd	FALSE
ddbbdcdbababdbcdadd	FALSE
ddbbddccacbddbdccab	FALSE
