abababbddb	TRUE
abababcbad	TRUE
abbdbbbaba	TRUE
abbdbbbddb	TRUE
abddbbdbda	TRUE
abddbcadba	TRUE
acbccadcbb	TRUE
acbcccdbbb	TRUE
acdcbbbacc	TRUE
acdcbbbbbc	TRUE
adbaccbccb	TRUE
adbacccacd	TRUE
adcdccccdc	TRUE
adcdcdcddd	TRUE
bacabdcabb	TRUE
bacacacabc	TRUE
bbabaccadb	TRUE
bbabaccccb	TRUE
bbccadbbdd	TRUE
bbccadcaca	TRUE
bcbadbbabd	TRUE
bcbadcacba	TRUE
bdabcddcdd	TRUE
bdabdacdbd	TRUE
bdcdabacac	TRUE
bdcdabbadc	TRUE
cabcdabdbc	TRUE
cabcdacdbd	TRUE
cadbdcbbbd	TRUE
cadbdccdbd	TRUE
cbbddbbcdd	TRUE
cbbddcbdcc	TRUE
ccacadbbda	TRUE
ccacaddbac	TRUE
ccdacbacbb	TRUE
ccdacbbdca	TRUE
cdbcbdacad	TRUE
cdbccabccb	TRUE
dabacabbac	TRUE
dabacabbca	TRUE
dacddcbbbb	TRUE
dacdddacab	TRUE
dbbacbddbb	TRUE
dbbaccacbb	TRUE
dbdcdcdadd	TRUE
dbdcdcdddc	TRUE
dccbbbcdcb	TRUE
dccbbdacac	TRUE
ddbabdbbdb	TRUE
ddbabdbccc	TRUE
aaaaaacbab	FALSE
aaaaacbdcb	FALSE
aacbddaadb	FALSE
aacbdddbdb	FALSE
abadbdccaa	FALSE
abadcaabba	FALSE
abdbabdcaa	FALSE
abdbabdcaa	FALSE
acbccddbaa	FALSE
acbcdabaab	FALSE
adababddaa	FALSE
adabaddcaa	FALSE
adcdbcbbaa	FALSE
adcdbdddaa	FALSE
babbbcaacc	FALSE
babbbdadaa	FALSE
baddbaaada	FALSE
baddbbabaa	FALSE
bbcacdcdaa	FALSE
bbcadaacdb	FALSE
bcadacacaa	FALSE
bcadbaddaa	FALSE
bcddbbdbaa	FALSE
bcddbcaabd	FALSE
bdccadddaa	FALSE
bdccadddaa	FALSE
caadcbdbdd	FALSE
caadccbbad	FALSE
cadcccbcaa	FALSE
cadccdbaab	FALSE
cbcabdcbaa	FALSE
cbcabddaaa	FALSE
ccaccabdaa	FALSE
ccaccbbaaa	FALSE
ccdaacadbb	FALSE
ccdaadbccd	FALSE
cdbcaaacad	FALSE
cdbcabbbaa	FALSE
daaadabbcd	FALSE
daaadadcba	FALSE
dacccaacbd	FALSE
dacccacdaa	FALSE
dbbaddabaa	FALSE
dbbaddacaa	FALSE
dbddbbddaa	FALSE
dbddbcacaa	FALSE
dcccccacaa	FALSE
dcccccadaa	FALSE
ddbacdbaab	FALSE
ddbadaabbc	FALSE
abababbddbb	TRUE
abababcadcb	TRUE
abbdabcccbc	TRUE
abbdacabbab	TRUE
abdcddccdca	TRUE
abddacdcdda	TRUE
acbcccdbcac	TRUE
acbccdbabad	TRUE
acdcadcadac	TRUE
acdcaddbadd	TRUE
adbbadbadca	TRUE
adbbaddabdd	TRUE
addacabcbca	TRUE
addacbabddd	TRUE
bacabddcbbd	TRUE
bacacabacbd	TRUE
baddcbddccd	TRUE
baddccacbbb	TRUE
bbccabcaddd	TRUE
bbccabcbbad	TRUE
bcbaccbacdd	TRUE
bcbaccbcdac	TRUE
bcddacbdbdc	TRUE
bcddadbcaca	TRUE
bdccabdcbbc	TRUE
bdccacaddca	TRUE
cabcdcbbdda	TRUE
cabcdcccbcb	TRUE
cadccbcbdbd	TRUE
cadcccbabad	TRUE
cbbdbccbaca	TRUE
cbbdbdcacda	TRUE
ccacadcbaba	TRUE
ccacbacbacc	TRUE
cccdbdbdbac	TRUE
cccdcabdcdb	TRUE
cdbbbacdada	TRUE
cdbbbaddcdc	TRUE
dababddbabb	TRUE
dabacadbadc	TRUE
dadabdcdbad	TRUE
dadacabdadc	TRUE
dbbbdcabcab	TRUE
dbbcabbcaca	TRUE
dcabbbcdcab	TRUE
dcabbdccddd	TRUE
dccddaccdda	TRUE
dccddadadab	TRUE
ddbadcdcbbc	TRUE
ddbaddaddcd	TRUE
aaaaaacbabb	FALSE
aaaaacdcbdd	FALSE
aaccadbbacb	FALSE
aaccadddabb	FALSE
abbaacbbdad	FALSE
abbaacbdcdc	FALSE
abdbaabbdaa	FALSE
abdbaadbcaa	FALSE
acbdacadcaa	FALSE
acbdacddcaa	FALSE
adaaddddddb	FALSE
adabaaaaddd	FALSE
adcdaadbacd	FALSE
adcdacaaaca	FALSE
babbacddbaa	FALSE
babbadcacaa	FALSE
bbaadddddba	FALSE
bbabaababcb	FALSE
bbccaadccbc	FALSE
bbccabbbaad	FALSE
bcbbcbcacaa	FALSE
bcbbcbdadaa	FALSE
bcdddcdcbaa	FALSE
bdaaaadaaac	FALSE
bdccadcaabb	FALSE
bdccaddccaa	FALSE
cabaacdddba	FALSE
cabaadccdbc	FALSE
cadadbcddaa	FALSE
cadadcccbaa	FALSE
cbbcdcaaadb	FALSE
cbbdaadcccc	FALSE
ccaadcaddcc	FALSE
ccaaddbbbbb	FALSE
cccccbbcdaa	FALSE
ccccccdcdaa	FALSE
cdbbbbabdaa	FALSE
cdbbbbdddaa	FALSE
daaabbdcabc	FALSE
daaabdccdbc	FALSE
dacdabcdbaa	FALSE
dacdaccddaa	FALSE
dbbacacdbaa	FALSE
dbbacbdcaac	FALSE
dbddaadaacd	FALSE
dbddadacaaa	FALSE
dcccaabddac	FALSE
dcccaacbbdb	FALSE
ddbbbbcacaa	FALSE
ddbbbbccaaa	FALSE
abababacccda	TRUE
abababcacbdd	TRUE
abcababdbdcd	TRUE
abcabadbbdbc	TRUE
abddcddcdbcc	TRUE
abdddaccbbda	TRUE
acbdaddccbba	TRUE
acbdbbcdccac	TRUE
acddcbddabdb	TRUE
acddccabbcca	TRUE
adbccdcbbbbb	TRUE
adbcdaccdcbc	TRUE
addcbcabdbdd	TRUE
addcbdabdcab	TRUE
baccacbddacc	TRUE
baccaccbdbcb	TRUE
bbadacddcdad	TRUE
bbadadadbcca	TRUE
bbdadbbdadcd	TRUE
bbdadbdbdcab	TRUE
bcbcabdaccda	TRUE
bcbcacacadcc	TRUE
bdabbcdbdacb	TRUE
bdabbcdddabd	TRUE
bdccdbadbacd	TRUE
bdccdcabddad	TRUE
cabddccdccac	TRUE
cabddcdacadc	TRUE
caddbcbdddca	TRUE
caddcadcabdc	TRUE
cbccbaccaccb	TRUE
cbccbbababdc	TRUE
ccaddbccbadc	TRUE
ccaddbddbdbb	TRUE
ccdcabacbcbb	TRUE
ccdcabbcbbbd	TRUE
cdcabbdadabd	TRUE
cdcabcacccbc	TRUE
dabbbabacdca	TRUE
dabbbaccbbcc	TRUE
dadbbddbcacb	TRUE
dadbcacccadc	TRUE
dbbdbacccacb	TRUE
dbbdbbaccbcd	TRUE
dcabcabddabc	TRUE
dcabcacabcad	TRUE
dccdadbcddcd	TRUE
dccdbabcacca	TRUE
ddbbacdbcbcb	TRUE
ddbbacdbcdba	TRUE
aaaaaadacbcc	FALSE
aaaaacbadbba	FALSE
aaccbddbcdbb	FALSE
aacccaadabdd	FALSE
abbbcbacadaa	FALSE
abbbcbdbbaaa	FALSE
acaaacbcbaab	FALSE
acaaadcbcada	FALSE
acccabbbbaaa	FALSE
acccabbbbbaa	FALSE
adbaccbaaaca	FALSE
adbacdaadcba	FALSE
addcababbaad	FALSE
addcabadbbaa	FALSE
bacacaddbdaa	FALSE
bacacbbcbbaa	FALSE
bbabbbbbcdaa	FALSE
bbabbbcbbaad	FALSE
bbcdcbcaabbb	FALSE
bbcdcbcccaab	FALSE
bcbcdabddaac	FALSE
bcbcdbbbddaa	FALSE
bdaaddbdbbad	FALSE
bdabaaacaddc	FALSE
bdcddbacbaad	FALSE
bdcddbdbbbaa	FALSE
cabaccddbaac	FALSE
cabacdababaa	FALSE
cadcbccdacaa	FALSE
cadcbdaacdad	FALSE
cbcaaadcddca	FALSE
cbcaadaacbbb	FALSE
ccadbaaabbdc	FALSE
ccadbbcdadaa	FALSE
ccdbcdcbdbaa	FALSE
ccdbcdcccaad	FALSE
cdbdacdaaddb	FALSE
cdbdbacdbbaa	FALSE
daacaaadbdab	FALSE
daacaabaadab	FALSE
dadaddabdaaa	FALSE
dadbaacbabca	FALSE
dbbddbbbbcaa	FALSE
dbbddbccddaa	FALSE
dcabdcadbaad	FALSE
dcabdcbdbcaa	FALSE
dcdababdbaad	FALSE
dcdabcaadbdc	FALSE
ddbcdaadbbcd	FALSE
ddbcdabaaaac	FALSE
abababacccdab	TRUE
abababcbbdddc	TRUE
abcabbcacbccb	TRUE
abcabcbdbdcad	TRUE
abddcbdbdbbba	TRUE
abddcdacddadb	TRUE
acbdacbaccdca	TRUE
acbdacbadcdcd	TRUE
acddbcccdddcb	TRUE
acddbcdababcd	TRUE
adbdadbcdadad	TRUE
adbdadccdcacb	TRUE
addcbbadccdda	TRUE
addcbbcdabccb	TRUE
bacbadddbaddb	TRUE
bacbaddddcdac	TRUE
bbabbbdbcbdac	TRUE
bbabbcacbbaba	TRUE
bbcbcdbaccacc	TRUE
bbcbdbabbcacb	TRUE
bcbbabdcccbda	TRUE
bcbbadbabadcd	TRUE
bdabadddbcbab	TRUE
bdabbabacacdb	TRUE
bdccdacccbcac	TRUE
bdccdbccaccbc	TRUE
cabcdcbbcddad	TRUE
cabcdcccbbbca	TRUE
caddacdabdcab	TRUE
caddadadbccdb	TRUE
cbcbabaddaddc	TRUE
cbcbabcbccddb	TRUE
ccadcabdabbad	TRUE
ccadcbacbbdac	TRUE
ccdbbdacdacbd	TRUE
ccdbbdccdadda	TRUE
cdbdcbcdbabac	TRUE
cdbdcbdadbdda	TRUE
dabbdbabdbdbc	TRUE
dabbdbbdadcac	TRUE
dadcacacbbabd	TRUE
dadcadbabacbd	TRUE
dbbdddacabdbd	TRUE
dbcababdbdcca	TRUE
dcacbabbbccba	TRUE
dcacbabcdcbac	TRUE
dccdbaccbdadd	TRUE
dccdbadbdadbb	TRUE
ddbbbdbbadbbd	TRUE
ddbbcbccbbbdd	TRUE
aaaaaaabdcacd	FALSE
aaaaaacddabbb	FALSE
aacbcadbdadac	FALSE
aacbccdabcbca	FALSE
abbaaacbccaac	FALSE
abbaabcacaddc	FALSE
abdcdadbccaad	FALSE
abdcdccddbdaa	FALSE
accaddbbdccaa	FALSE
accadddccabaa	FALSE
adacdddbaacda	FALSE
adadabaaaacbd	FALSE
addbbcacbbbaa	FALSE
addbbcddcbaaa	FALSE
babddacbcdaaa	FALSE
babddacbcdbaa	FALSE
bbacdbbdcdbaa	FALSE
bbacdcdaccdaa	FALSE
bbdbddcdbbdaa	FALSE
bbdcaaadacdac	FALSE
bccbbdbcadbaa	FALSE
bccbbddaaacba	FALSE
bdacdadacbdaa	FALSE
bdacdbcadbdaa	FALSE
bddaacddbaabb	FALSE
bddabbddabdaa	FALSE
cabbdcbcbbcaa	FALSE
cabbdcccaadab	FALSE
cbaaaacbcbbab	FALSE
cbaaabaddacab	FALSE
cbcacddbdcaac	FALSE
cbcadaaaaaddc	FALSE
ccbabdcddbdaa	FALSE
ccbacacadcaad	FALSE
ccdcadcbcabaa	FALSE
ccdcadcccadaa	FALSE
cdcaadaddbadd	FALSE
cdcaadbcccdda	FALSE
daadabcddcbbc	FALSE
daadaccccabdc	FALSE
dadabbbacbaac	FALSE
dadabbcaacacc	FALSE
dbbccdadcdbaa	FALSE
dbbcdaadccadd	FALSE
dcabadbbcabaa	FALSE
dcabadbdacbaa	FALSE
dcdabdbdcdcaa	FALSE
dcdabdcbacdaa	FALSE
ddbbdaacadcad	FALSE
ddbbdabdddaab	FALSE
abababbbaccaca	TRUE
abababbccadccb	TRUE
abbdcbcabbbadd	TRUE
abbdcbcbbddccb	TRUE
abdcdcdbadacdd	TRUE
abdcdcdbadbdac	TRUE
acbcacbaccadab	TRUE
acbcaccbbacbdc	TRUE
acdcabbdbaddbd	TRUE
acdcabcabccbca	TRUE
adbcbcbccbacac	TRUE
adbcbccdddbddd	TRUE
addbdbdbabdbad	TRUE
addbdcdabbacdc	TRUE
baccabbabcabba	TRUE
baccacacdbcabd	TRUE
bbacbdddabcddb	TRUE
bbaccabaccdabb	TRUE
bbdabcdcbdbddd	TRUE
bbdabdcdddbbdc	TRUE
bcbdbdabdadbba	TRUE
bcbdbdadcbbbab	TRUE
bdacbdbdabdacd	TRUE
bdacbdbdccbcbc	TRUE
bddacabdadabcd	TRUE
bddacacadcadbd	TRUE
cacacbcacbabdb	TRUE
cacaccbcabcbbb	TRUE
cbabacbbdcdaca	TRUE
cbabaddcbbdaba	TRUE
cbccdbccacbacc	TRUE
cbccdbcdacbcdd	TRUE
ccaddddaddacda	TRUE
ccbabababbbdac	TRUE
ccdddbcbbadbbc	TRUE
ccdddcbcabacac	TRUE
cdcbdaccbbcccc	TRUE
cdcbdbbcbabbbc	TRUE
dabbdcccabdbbd	TRUE
dabbddabbbadac	TRUE
dadbcadbcddadd	TRUE
dadbcbbdcabdcc	TRUE
dbbdbbcacaddcb	TRUE
dbbdbbcbacabba	TRUE
dcabcdcdccbacb	TRUE
dcabcddcddbdbc	TRUE
dccdbbdcbaddcc	TRUE
dccdbcdadcdbcc	TRUE
ddbaddcbcbadad	TRUE
ddbaddddcddcdd	TRUE
aaaaaaabdcacdd	FALSE
aaaaaacdabbbcd	FALSE
aacbcbcbadaadd	FALSE
aacbcbdcbdabdb	FALSE
abbaabbbdcabba	FALSE
abbaacbdabdbab	FALSE
abdcccacddddaa	FALSE
abdcdabcccbaab	FALSE
accacaddcacaac	FALSE
accacbaacddbac	FALSE
adacbdddbdbbaa	FALSE
adaccaacaacbbd	FALSE
addabdcccabaad	FALSE
addacacddaacab	FALSE
bacabcccddbaac	FALSE
bacacaabbbbada	FALSE
bbacdddcccdbaa	FALSE
bbadabaaacadbc	FALSE
bbdbcbbaacbcaa	FALSE
bbdbcbbadcbbaa	FALSE
bccaacdadbaabb	FALSE
bccaadabbaabaa	FALSE
bdacbbcbbbabaa	FALSE
bdacbcbdbbbdaa	FALSE
bddabbcdabdcaa	FALSE
bddabbdadadbaa	FALSE
cabcbdadcccbaa	FALSE
cabcbdbdacadaa	FALSE
cbaacaabdddbbd	FALSE
cbaaccdcbdbbab	FALSE
cbccddddccacaa	FALSE
cbcdaababdbbbd	FALSE
ccbabcbccacbaa	FALSE
ccbacaddcbabaa	FALSE
ccdbddcbbdacaa	FALSE
ccdcaabcdabcba	FALSE
cdbdcbcacbbdaa	FALSE
cdbdcbddaccbaa	FALSE
daacbbdacbdccd	FALSE
daacbdaddbaaaa	FALSE
dadaaabdaddbab	FALSE
dadaababbbaaad	FALSE
dbbcccdbcdabaa	FALSE
dbbccdbddabdaa	FALSE
dcabbaadabacdb	FALSE
dcabbadaccdcaa	FALSE
dccdbbcacdcdaa	FALSE
dccdbcaacdbcdb	FALSE
ddbbcccacadcaa	FALSE
ddbbcccddabdaa	FALSE
abababababcacda	TRUE
abababacbdbbbab	TRUE
abbdadaccdbccdc	TRUE
abbdadaddababba	TRUE
abdcccbbddbdbba	TRUE
abdcdabbcdadacb	TRUE
acbbababcabcdcb	TRUE
acbbabadbdbadcb	TRUE
acdbbaddbcabbcc	TRUE
acdbbcacbadcdcc	TRUE
adbbbdbbccacdcb	TRUE
adbbcacccbabddb	TRUE
addbababbabdbcc	TRUE
addbabacbdcbbcb	TRUE
bacacbcaddbdadb	TRUE
bacacdbccbadabb	TRUE
bbabbccacababbc	TRUE
bbabbcccddadbca	TRUE
bbcdbababcbcdbc	TRUE
bbcdbadcbbababb	TRUE
bcbbdaddccbcdcc	TRUE
bcbbdbacbaccacc	TRUE
bdabbbcababacac	TRUE
bdabbbdccabbcba	TRUE
bdccdbdddaddabb	TRUE
bdccdcddadbbcac	TRUE
cabdddacdbbcacd	TRUE
cabdddbcacbbbbc	TRUE
cadddddcadcdcba	TRUE
cbababacccaddda	TRUE
cbcbbdbadbcbaca	TRUE
cbcbbdbbbdbbdcc	TRUE
ccadccdadadcacc	TRUE
ccadcdcadccabbd	TRUE
ccdadabbbcbcccb	TRUE
ccdaddbcbacadac	TRUE
cdbdddacdbdadac	TRUE
cdcabcabdcaddcd	TRUE
dabccbadbcddbad	TRUE
dabcccadbaccbdb	TRUE
dadcacbdbadbcbb	TRUE
dadcadbacdbddbb	TRUE
dbcabdbbbaccbdb	TRUE
dbcacbbccddccca	TRUE
dcaccadbcabacac	TRUE
dcaccbadbdabccc	TRUE
dcdaccdbbccabdd	TRUE
dcdacdbbacbddcc	TRUE
ddbcabdddbcdcda	TRUE
ddbcacadcacdddb	TRUE
aaaaaaaaabdcbac	FALSE
aaaaaaaacbcaddd	FALSE
aacbcadaaadacdb	FALSE
aacbcbcbdbaadcc	FALSE
abbacbaabbbaccd	FALSE
abbacbddbbbcbaa	FALSE
abdcadadadcadaa	FALSE
abdcbbadcbadbaa	FALSE
acbdccbcdccabaa	FALSE
acbddababbbacaa	FALSE
adacdbaabdbbabc	FALSE
adacdbcacaabbbc	FALSE
addadbdccbbccaa	FALSE
addadcaaaabcdbd	FALSE
babcdaadcaadcdb	FALSE
babcdacdbacccaa	FALSE
bbaacaabcaacbca	FALSE
bbaacbaccbaadad	FALSE
bbcdaadcbcabbbd	FALSE
bbcdabaadddbccb	FALSE
bcbbbdbdbdddaad	FALSE
bcbbbdcccaaabdd	FALSE
bdabbaaddcdbdab	FALSE
bdabbacbbdaccaa	FALSE
bdcdcddaaddccdc	FALSE
bdcddaadaabdbaa	FALSE
cabbccdcbaccbaa	FALSE
cabbcdbdabdabaa	FALSE
cadddaacddbacbd	FALSE
cadddbadddaccaa	FALSE
cbcbaddcdcabaac	FALSE
cbcbbabccaabbbb	FALSE
ccbaddbaaaacdad	FALSE
ccbbaabcaabcbcd	FALSE
ccdccdbdcabddaa	FALSE
ccdccdcdabcdbaa	FALSE
cdcbcccccbacaac	FALSE
cdcbcdcadaacabd	FALSE
daadccdadbbcabb	FALSE
daaddbcabcdabdd	FALSE
dadbcaccccdbcaa	FALSE
dadbcbaabaccadd	FALSE
dbbdcddbadacbaa	FALSE
dbbdcddddacbdaa	FALSE
dcabbddbcacaaab	FALSE
dcabcbccacbacaa	FALSE
dccdcabdcaabdaa	FALSE
dccdcbccccbccaa	FALSE
ddbbccddadbadaa	FALSE
ddbbcdacdaaaccd	FALSE
abababcbbccdbcdc	TRUE
abababccdcccdbcb	TRUE
abbddacddabdacbc	TRUE
abbddadbcaccabac	TRUE
abddbbcbdabbbcdb	TRUE
abddbcdcabaddacd	TRUE
acbccbdbddbdacba	TRUE
acbcccadbbbaddbc	TRUE
acdbdabbdcdccadd	TRUE
acdbdacdabbddabb	TRUE
adbadbabbabbbaba	TRUE
adbadbabdcabcbab	TRUE
addadbbbbaccadac	TRUE
addadbbcbadbadbb	TRUE
bacabdbdcdaddbba	TRUE
bacabdccbdccdcab	TRUE
bbabbbaddbddbabd	TRUE
bbabbbbbbbaddadd	TRUE
bbcdccccdbabbdda	TRUE
bbcdcddadddbacab	TRUE
bcbcdbaccbbacadb	TRUE
bcbcdbaccdacdbca	TRUE
bdabdcbcdadbcccc	TRUE
bdabddabcacddbdd	TRUE
bddabdaddabbbdac	TRUE
bddabddbddccadcc	TRUE
cacadbbaddcddbdb	TRUE
cacadbbdcccccacb	TRUE
cbabbccdbabccabb	TRUE
cbabbcdcbccccbab	TRUE
cbcbdcdbaccbabcc	TRUE
cbcbddbcbccccbbd	TRUE
ccbbbbbccaccabad	TRUE
ccbbbbcbdbdadbbb	TRUE
ccdcdddabbbbccdd	TRUE
ccddabccbabdddac	TRUE
cdcabddadaddddba	TRUE
cdcacbbcadddbbdd	TRUE
dabbdcbacccccdca	TRUE
dabbdcddacabadac	TRUE
dadadddddddadccd	TRUE
dadbadaddadabdab	TRUE
dbbcbbacbbcbadbb	TRUE
dbbcbbccdbdbabab	TRUE
dcabddbbcbacccdc	TRUE
dcabddccccdccdba	TRUE
dccdacadbcdcdadd	TRUE
dccdacadcbcabcbc	TRUE
ddbbdcbadccabaca	TRUE
ddbbdccabcbbcdbd	TRUE
aaaaaababcdcacac	FALSE
aaaaaabacdaacada	FALSE
aaccbacdcbcbcadb	FALSE
aaccbadacbaaccba	FALSE
abbababcdcbdacaa	FALSE
abbabccddaabcaaa	FALSE
abdbabdacbbadbaa	FALSE
abdbacadcadcabaa	FALSE
acbcaccacaddbbaa	FALSE
acbcaddabacbccaa	FALSE
adaadbcddccbdbcd	FALSE
adaadcdcbddbabab	FALSE
addabcddccbaddaa	FALSE
addabdaabdcbdbac	FALSE
babcbbddcbdbbbaa	FALSE
babcbdbaadaadcdd	FALSE
bbabcccbccddcbaa	FALSE
bbabccdbcdcbbdaa	FALSE
bbcddcbbdcbddbaa	FALSE
bbcddccadacbcdaa	FALSE
bcbccadadbdacbaa	FALSE
bcbccbcabcabbcaa	FALSE
bdaabacdbccacdbb	FALSE
bdaabadabdaccbcc	FALSE
bdcdbabdcacbdaaa	FALSE
bdcdbaccdaccdbaa	FALSE
cabbdccbcccadaac	FALSE
cabbdddadcbbcbaa	FALSE
cbaaaaaccabadcac	FALSE
cbaaacbcbcdbaddc	FALSE
cbccdbcacdabcaab	FALSE
cbcdaadbacaaacbc	FALSE
ccbbbaabdcccbada	FALSE
ccbbbabcdadacbaa	FALSE
ccddbbacbaddabaa	FALSE
ccddbbbbaacccddb	FALSE
cdcacccdaadddbba	FALSE
cdcacdadbcbbcdaa	FALSE
daaccaccbdbdadda	FALSE
daaccbbadddaabbc	FALSE
dadaaacdccabacbb	FALSE
dadaabbcddcbdacb	FALSE
dbbcdbbdadbaabad	FALSE
dbbdaaabcaacddba	FALSE
dcabbccdadadcdaa	FALSE
dcabbdaacbcdacad	FALSE
dcdaacbdbcddcdac	FALSE
dcdaacdaacccbbdb	FALSE
ddbbcabbbcbaddaa	FALSE
ddbbcabccaddacaa	FALSE
abababacaccbaddbb	TRUE
abababcbacbddcccb	TRUE
abbdaccaddbaddbdc	TRUE
abbdaccdaccdcaddc	TRUE
abdcdadbabbddabcc	TRUE
abdcdadbdabcbddcc	TRUE
acbcdcdacdbadbcac	TRUE
acbcdcdbbbbdbddac	TRUE
acdccadbcdbbbacac	TRUE
acdccaddbcbbacaba	TRUE
adbcbaddcbcbadacc	TRUE
adbcbaddddcbcbdcc	TRUE
addbdaddacccbacda	TRUE
addbdbdccacadbbcd	TRUE
bacadcdbddbbbbcbd	TRUE
bacaddbcbbddbccba	TRUE
bbabcbadadbacccca	TRUE
bbabcccbbacbaddab	TRUE
bbcdbdbbbabccdcdc	TRUE
bbcdcabdacacbbdcd	TRUE
bcbbcadadbbbcdaca	TRUE
bcbbcbbcddadcddac	TRUE
bcdddddacabdcbcda	TRUE
bdabababccbcbaddc	TRUE
bdcbbadcdacdadacc	TRUE
bdcbbbacacbbadcbb	TRUE
cabdabbbddddcccdc	TRUE
cabdabdbacbbacdba	TRUE
cadbdccabdbbddccd	TRUE
cadbdccdddacacbbd	TRUE
cbbdaddddabdccacc	TRUE
cbbdbacacccadbddb	TRUE
ccacabdabacbbbbcd	TRUE
ccacacadcbccdddcd	TRUE
cccddbcddbcbbbdbd	TRUE
cccddcddddbdbbbcc	TRUE
cdbbdbadabcdacbab	TRUE
cdbbdbcccccccbabc	TRUE
cddddadabbadabadb	TRUE
cddddbddbacadabdc	TRUE
daccdbbbbcdabdcbc	TRUE
daccdbbccadccadac	TRUE
dbbabcdcdabacbabd	TRUE
dbbacbacdcdcbcbcb	TRUE
dbddbdacbacbbdbac	TRUE
dbddbdbdaccbcabab	TRUE
dcccbbacababdddcb	TRUE
dcccbcadcdacdbcdd	TRUE
ddbadabcccadcdcab	TRUE
ddbadaddabcbadbdc	TRUE
aaaaaaddbdadadacb	FALSE
aaaaabaccbaacabcc	FALSE
aaccbabdacbbbdbbc	FALSE
aaccbbadbadcbdbcd	FALSE
abbabddababcabaac	FALSE
abbacdaaddccbbaba	FALSE
abdcddcadaaccbdaa	FALSE
abddaacdcadccccdc	FALSE
accadbdcdadcdbdaa	FALSE
accadcadcaddbbaac	FALSE
adacbbbcabcadccaa	FALSE
adacbcabcabbabbaa	FALSE
addaaccdcaaccacac	FALSE
addabaabaabcaaacd	FALSE
babddaccdcbacadaa	FALSE
babddbacbccacadaa	FALSE
bbadaccdbdbddbbaa	FALSE
bbadadbbcbdbcbbaa	FALSE
bbdbcabaadabbbbdc	FALSE
bbdbcbcdaddbdbcaa	FALSE
bcbdcadcdbcbacdaa	FALSE
bcbdcaddabcddacaa	FALSE
bdabadabcdadadaaa	FALSE
bdabadbdcadccbcaa	FALSE
bdcccdacdbbacdbaa	FALSE
bdccdaadcdcaccbad	FALSE
cababbbcbbdadbaad	FALSE
cababbcababdbcdaa	FALSE
cadbddbaddbbdccaa	FALSE
cadcaabbddbddabba	FALSE
cbcaaadcbcbdabbad	FALSE
cbcaacbabbadadabd	FALSE
ccaccbdaddbbaaaaa	FALSE
ccacccdcadbbcbcaa	FALSE
ccdbcbbcadadcacaa	FALSE
ccdbccdcbcacbadaa	FALSE
cdbccbbbbbaaaacdc	FALSE
cdbccbbbcbddcbcaa	FALSE
cddddbbdbbcbcdaaa	FALSE
cddddbdcdcaababcc	FALSE
daccdcbbdbaccddaa	FALSE
dacdaaadaaadddacd	FALSE
dbbaacabcdccdaccd	FALSE
dbbaacadbabbaccdc	FALSE
dbdcddcadaddccaad	FALSE
dbddaacabcadbbccc	FALSE
dcccaabaadaabbacc	FALSE
dcccabdbcbaaacbab	FALSE
ddbacbadcbabdbaab	FALSE
ddbacbccddacabaad	FALSE
ababababdbcdbbdbac	TRUE
abababdbbacbcadacc	TRUE
abbddbcaddbaccbbcd	TRUE
abbddcadabbdbcdbbd	TRUE
abdcddcbbdcabbbadb	TRUE
abddabadadcdabadac	TRUE
acbccdaddbabdcddca	TRUE
acbccdcadcddcccbad	TRUE
acdbcbaddacbbdacbd	TRUE
acdbcbbadddadcabbc	TRUE
adbbcbdcabdaccdbdd	TRUE
adbbccadcbadddccdb	TRUE
addbbdbcbacdbcaccc	TRUE
addbcbccacbdacccab	TRUE
bacacacbcdccbccbcb	TRUE
bacacbbadcddadcdab	TRUE
badddaddadabcddcba	TRUE
badddbbcbbcadbdcbb	TRUE
bbccdabdcdbdbdadca	TRUE
bbccdacbccdabbccbc	TRUE
bcbadbbdacdcacadba	TRUE
bcbadbccddddcdaccb	TRUE
bdabaddcdcccadbbcc	TRUE
bdabbadccbdadcddac	TRUE
bdcbcdcababdbdcbdd	TRUE
bdcbdacacbbdcbddbb	TRUE
cabcdbccdadbcaddbd	TRUE
cabcdbddbaccbabbca	TRUE
caddbdcdddddabacdc	TRUE
caddcabdcbcccabcda	TRUE
cbcbbbccccbbdabcbb	TRUE
cbcbbbdbdddadaddcb	TRUE
ccadcababadbacbdbb	TRUE
ccadcbbccacbddadda	TRUE
ccdaddcbcbdacccbda	TRUE
ccdaddccadadcbcacd	TRUE
cdcacdcabbabdbddba	TRUE
cdcadacadbbadbbacb	TRUE
dabbbadbdadccdcabc	TRUE
dabbbaddddcdacadad	TRUE
dadbdaccdadbdccabb	TRUE
dadbdaccdbadddcaba	TRUE
dbbcacbdccdddccacd	TRUE
dbbcbabddddcdacbcb	TRUE
dcabdccabacdbddadd	TRUE
dcabdccbbdacaddcac	TRUE
dcdaccbabbdbabbbac	TRUE
dcdacdddbdbacdbcbb	TRUE
ddbcccdbadccccadcb	TRUE
ddbccdcacadbcacbca	TRUE
aaaaaadcbbaadaabad	FALSE
aaaaabbdcbcbcddccc	FALSE
aacbcbacdadcadccbd	FALSE
aacbcbbbdbaabbbbdd	FALSE
abadbdcdcdddbcccaa	FALSE
abadcaacbbcddcbdbc	FALSE
abdbadbacdcbcabdaa	FALSE
abdbaddccdddabbcaa	FALSE
acbdbacdaabadccdca	FALSE
acbdbccaadaaadcada	FALSE
adaadcadbddaccdccc	FALSE
adaaddcaabbbacddba	FALSE
addacaddaddcdbbcaa	FALSE
addacbbaccbdacadaa	FALSE
babdbaccbaddbbdbaa	FALSE
babdbdacadabcdcdaa	FALSE
bbaadbddcbdcabbcdd	FALSE
bbaadcaabcadcdaabc	FALSE
bbccbcdaddcbdaabdd	FALSE
bbcccbdcbadcbcddaa	FALSE
bcbbbcdbabdaabcccc	FALSE
bcbbcbcbcbaaaaadac	FALSE
bcddbbddcdddacadaa	FALSE
bcddbcbdbbacdbbbaa	FALSE
bdcbcdbcbcaccaacda	FALSE
bdcbcddaaabdbbabab	FALSE
caadbccacaaaaabbad	FALSE
caadbdddaacadacccb	FALSE
cadbbdbdaaccabddca	FALSE
cadbcacbcdbbcbddaa	FALSE
cbbcaddddddaccbbaa	FALSE
cbbcbabcdbaddbcbaa	FALSE
ccaabcddbbccabdcab	FALSE
ccaacaacbdcadcbbaa	FALSE
ccdaadcbbddcdcbdad	FALSE
ccdaaddccbdcbdbaba	FALSE
cdcaaabbbaaaabddba	FALSE
cdcaaabccbadacbacb	FALSE
daacbdadbcbabbcddb	FALSE
daacbdbbcccccddadb	FALSE
dadaabddaaccbbbccd	FALSE
dadaacadccbdccaddc	FALSE
dbbcbdcbbadabadcaa	FALSE
dbbccbddbbbdcbddaa	FALSE
dcaaccdcdabbbcabbb	FALSE
dcaacdaaccabcccccc	FALSE
dccdccdddaaacddbac	FALSE
dccddaabcadacbddbc	FALSE
ddbbddbbbaddcbcbaa	FALSE
ddbcaadaddddabaaba	FALSE
abababacabbccdcbdab	TRUE
abababbdbacadccdcdd	TRUE
abcabddddcddabbdbdc	TRUE
abcacacacbccabbdcbd	TRUE
acabacdcacabcbbbcbd	TRUE
acabadabdaddddbabda	TRUE
acbccbcadddccdddbad	TRUE
acbcccabadcbccadadb	TRUE
acdcddddadbcadabbcc	TRUE
acddabbabcddbcbbbbd	TRUE
adbdabbbbcabcdacbad	TRUE
adbdabbcacbddbadcac	TRUE
addcdbdadccacdbcadb	TRUE
addcdcbdcbbcdbcbddc	TRUE
bacdadacdbdacbbaddb	TRUE
bacdadbcbcbbcdbcbba	TRUE
bbadacdabcadddadccd	TRUE
bbadacdabdcdbacabbd	TRUE
bbdbbcacddaccacdcbd	TRUE
bbdbbcbacddbdcdbaba	TRUE
bcbddcdbacacabcaccb	TRUE
bcbdddacdccbdbbbacb	TRUE
bdacacbccdbadcdbdcb	TRUE
bdacacdccccbacddcbd	TRUE
bddabadbdabddadbdab	TRUE
bddabbddcbcdbcbadbc	TRUE
cacaddddabdddadadab	TRUE
cacbabadbacdcdcdacc	TRUE
cbabcbcbccbcabccacb	TRUE
cbabccdcbdddcbccbca	TRUE
cbcbdcdbccbadadcdcc	TRUE
cbcbddbcbbcccddbdda	TRUE
ccaddcadcdcdbbbbdca	TRUE
ccaddcbbbbaccdbccac	TRUE
ccdcdadbadabbbcabca	TRUE
ccdcdadcddadabccbdd	TRUE
cdcadbadacbadccdcac	TRUE
cdcadbadadccbbdbbcd	TRUE
dabccadbdadcdbababb	TRUE
dabccadccbdabbaccba	TRUE
dadbdacdbababccacdd	TRUE
dadbdcccbcdbdbdbccb	TRUE
dbbdcdcddddaccadada	TRUE
dbbdcddadacabbcbcad	TRUE
dcaccaccddacadadbbc	TRUE
dcaccbacdcacddcdbda	TRUE
dcdabadacbabcbcbccb	TRUE
dcdabbaccdadabdcbcc	TRUE
ddbcbadbccdbddacbca	TRUE
ddbcbbdadccddcbadac	TRUE
aaaaaaaaaccbcaccdca	FALSE
aaaaaacbcadacacadba	FALSE
aacbddddcccaadccdbb	FALSE
aaccabcabcaabdbaaaa	FALSE
abacbacbdadcdadaadb	FALSE
abacbbccabbbddaadac	FALSE
abdabbcabcbcabddcaa	FALSE
abdabbdaacbbabbabad	FALSE
acbcdaaabadaacadcdb	FALSE
acbcdbccdabaddddaac	FALSE
adaaabcbdbcadbdadbc	FALSE
adaabaccbadbcaddcca	FALSE
adccccaabbcabccacab	FALSE
adcccccbbabddbbdaac	FALSE
babbbabcdbbdadbddaa	FALSE
babbbbbccbcacadacaa	FALSE
badcdadcbdbbccbbcaa	FALSE
badcdbaacabcabcaccc	FALSE
bbcbbdaccaabcabdbdb	FALSE
bbcbbdaddbaadcdcbdb	FALSE
bcadddbccdacadcdaaa	FALSE
bcbaaabddbabdacabbb	FALSE
bcdbcbbbbcabbacbaad	FALSE
bcdbcbcabcbbdcaccaa	FALSE
bdcaaabbdcacdbdabcc	FALSE
bdcaacdabbadccbcaba	FALSE
caadbddaadaacdabbbc	FALSE
caadcaabcaccbdbbddb	FALSE
cadabcbababdcbcadaa	FALSE
cadabcbdddbcbdbdbaa	FALSE
cbbbbbbacbcccbbaaaa	FALSE
cbbbbbdabbbddcbbcaa	FALSE
cbdcddcdbbbaaaabdaa	FALSE
cbddaadbbbabaadbbdc	FALSE
cccbdbccadacbdbcaab	FALSE
cccbddcaabdbacadcca	FALSE
cdbaaacbcbbcacbacdc	FALSE
cdbaaccdcdadbabcacd	FALSE
cddddbbdaaacadabddc	FALSE
daaaaacdcdbdcdddcac	FALSE
dacdaddcbbccacdbcaa	FALSE
dacdbbdbcdaadddbbcc	FALSE
dbbbdacaddaddaddbaa	FALSE
dbbbdadddcadcaaaadb	FALSE
dcaacdaaacbdcdccddb	FALSE
dcaacdbddbabdbbcdab	FALSE
dccdadacdccabacccaa	FALSE
dccdadcddaaacbaaaaa	FALSE
ddbaccdcdbddbdcacaa	FALSE
ddbadacdcdbcbcdabaa	FALSE
