adadadadad	TRUE
adadadadad	TRUE
adadccdcbd	TRUE
adadcdadca	TRUE
adbbbcccad	TRUE
adbbbccdbc	TRUE
adcadadcdb	TRUE
adcadadcdb	TRUE
adccdadbda	TRUE
adccdadcca	TRUE
addbbbccad	TRUE
addbbbcccc	TRUE
addddbadcb	TRUE
addddbbbad	TRUE
badcaddadd	TRUE
badcaddcad	TRUE
bbadccadad	TRUE
bbadccbbad	TRUE
bbdadbbbdb	TRUE
bbdadbcbdd	TRUE
bcbaddddcb	TRUE
bcbbadbcdb	TRUE
bcdcdddcdc	TRUE
bcddadbbcc	TRUE
bdcbbdadcc	TRUE
bdcbbdadcd	TRUE
cadadcdccc	TRUE
cadadcdcda	TRUE
caddbcbbbd	TRUE
caddbcdbca	TRUE
cbbddadadd	TRUE
cbbddadbad	TRUE
ccadcddcad	TRUE
ccadcdddbd	TRUE
ccdbbadcba	TRUE
ccdbbcbccc	TRUE
cdbdddadbc	TRUE
cdcadadbad	TRUE
dadadcccbd	TRUE
dadadcccbd	TRUE
daddadcbbc	TRUE
daddadccdd	TRUE
dbbcddaddb	TRUE
dbbcddbbdd	TRUE
dcadcadccc	TRUE
dcadcaddad	TRUE
dcdadcbadd	TRUE
dcdadcbdcb	TRUE
ddbbdadbdd	TRUE
ddbbdbbdcd	TRUE
aaaaaabbbb	FALSE
aaaaaabbcc	FALSE
aaccdcdbab	FALSE
aaccddbbdc	FALSE
abbbcaccbc	FALSE
abbbcbbbdd	FALSE
acaabbdcdb	FALSE
acaabccccd	FALSE
accddadabd	FALSE
accddcaacb	FALSE
adbbddddab	FALSE
adbcaacdab	FALSE
adddababca	FALSE
adddabbddb	FALSE
bacacbabad	FALSE
bacacbdccc	FALSE
bbacbbcdab	FALSE
bbaccaaacc	FALSE
bbdaccbadd	FALSE
bbdadaabcc	FALSE
bcbccacdbb	FALSE
bcbccdbcac	FALSE
bdaabbaabb	FALSE
bdaabbcaba	FALSE
bdcbbccbab	FALSE
bdcbbdbacd	FALSE
caadabbcdb	FALSE
caadabdabd	FALSE
cadbdbbbab	FALSE
cadbdcabab	FALSE
cbcabcddaa	FALSE
cbcabddacc	FALSE
ccacadacdd	FALSE
ccacadcacb	FALSE
ccdadaccdd	FALSE
ccdadadbaa	FALSE
cdbdccbacd	FALSE
cdbdcccdab	FALSE
daacbdccad	FALSE
daaccadcad	FALSE
dadaacaaad	FALSE
dadaacbaac	FALSE
dbbcbbadaa	FALSE
dbbcbcbbac	FALSE
dcaaaacaca	FALSE
dcaaababbc	FALSE
dccccdbbac	FALSE
dcccdabcbb	FALSE
ddbaddbdac	FALSE
ddbaddddab	FALSE
adadadadada	TRUE
adadadadada	TRUE
adadcdadbdc	TRUE
adadcdaddad	TRUE
adbbbdcbbcb	TRUE
adbbcadadad	TRUE
adcadadcbda	TRUE
adcadadcbdc	TRUE
adccdddbadb	TRUE
adccdddbcbd	TRUE
addbbddbdbd	TRUE
addbcadadcb	TRUE
addddadcadc	TRUE
addddadcadd	TRUE
badcbadbcba	TRUE
badcbaddadb	TRUE
bbadcdaddad	TRUE
bbadcdaddda	TRUE
bbcddbdddbd	TRUE
bbcddcaddbb	TRUE
bcbbbadbdbd	TRUE
bcbbbbbaddc	TRUE
bcdccdcbcdc	TRUE
bcdcdadadcb	TRUE
bdcaddadcdd	TRUE
bdcbadbdddc	TRUE
cadaddcbddc	TRUE
cadaddccada	TRUE
caddbddbdad	TRUE
caddbddcdda	TRUE
cbbdbadcdbb	TRUE
cbbdbbbddcd	TRUE
ccadaddadda	TRUE
ccadaddcada	TRUE
cccdbdadcba	TRUE
cccdcadddcd	TRUE
cdbdadddddb	TRUE
cdbdbbbbada	TRUE
dadadcbddba	TRUE
dadadccadda	TRUE
daddadddada	TRUE
daddadddada	TRUE
dbbcdddadad	TRUE
dbbdadadddc	TRUE
dcadbccdadc	TRUE
dcadbccddad	TRUE
dccccbddbbd	TRUE
dcccccadcda	TRUE
ddbaddcadad	TRUE
ddbaddcdcba	TRUE
aaaaaabbbbc	FALSE
aaaaaabbccc	FALSE
aacdaccbbbc	FALSE
aacdacdbcad	FALSE
abbccadadcd	FALSE
abbccbcccdc	FALSE
acaabcacadb	FALSE
acaabcddbab	FALSE
accdbacddcc	FALSE
accdbbcbbba	FALSE
adbbdabacaa	FALSE
adbbdabbabc	FALSE
adddbaadaba	FALSE
adddbcacaab	FALSE
babdcdccdac	FALSE
babddaccddd	FALSE
bbacacbbcaa	FALSE
bbacadacccd	FALSE
bbdabbbddda	FALSE
bbdabdadbdd	FALSE
bcbcdabdaba	FALSE
bcbcdaddbaa	FALSE
bcddcbcccac	FALSE
bcddcbddbaa	FALSE
bdcbbdaccca	FALSE
bdcbbdccacb	FALSE
caadacdcaac	FALSE
caadbadddbb	FALSE
cadbcdaddac	FALSE
cadbcdbaaac	FALSE
cbcabbbcccc	FALSE
cbcabcaccdc	FALSE
ccacdcacbad	FALSE
ccacddabcad	FALSE
cccdddabdbb	FALSE
cccddddaabc	FALSE
cdbdbbbccac	FALSE
cdbdbbcacac	FALSE
daabddbacbd	FALSE
daabddbcbda	FALSE
dadadddddac	FALSE
dadbaaaadad	FALSE
dbbdbbccaab	FALSE
dbbdbbdbaaa	FALSE
dcabbdcdacb	FALSE
dcabcadbdcb	FALSE
dccdbbdbdaa	FALSE
dccdbcbadac	FALSE
ddbbcaddbaa	FALSE
ddbbcbbcdaa	FALSE
adadadadadad	TRUE
adadadadadad	TRUE
adadcddbbadd	TRUE
adadcddccada	TRUE
adbbbadadbda	TRUE
adbbbadbadad	TRUE
adbdccbbcbad	TRUE
adbdccdcbdcb	TRUE
adccadccdcad	TRUE
adccadccdccc	TRUE
addadccbadad	TRUE
addadcccbcdb	TRUE
adddadadddbd	TRUE
adddadbadadb	TRUE
badbaddaddcb	TRUE
badbaddcbada	TRUE
badddccdcbcd	TRUE
baddddadbdcc	TRUE
bbccbdbbdcbc	TRUE
bbcccadcbadb	TRUE
bcbaddbdbada	TRUE
bcbadddaddbb	TRUE
bdadadadbcad	TRUE
bdadadadbdbb	TRUE
bdcadddadada	TRUE
bdcadddadada	TRUE
cadadbdcbadc	TRUE
cadadbdcdbad	TRUE
cadcdbdadccb	TRUE
cadcdbdaddba	TRUE
cbbcadbaddad	TRUE
cbbcadbaddda	TRUE
ccadaddbadcc	TRUE
ccadaddbbadb	TRUE
cccddbdddbcc	TRUE
cccddddbadad	TRUE
cdbdaddbadad	TRUE
cdbdaddbbcbc	TRUE
dadadbcbadbc	TRUE
dadadbcbbadd	TRUE
dadccdcaddbc	TRUE
dadccdddadad	TRUE
dbbbadcbadcb	TRUE
dbbbbaddadbb	TRUE
dcadadadadad	TRUE
dcadadadbbad	TRUE
dcccadbbbbba	TRUE
dcccaddadada	TRUE
ddbbbadadcad	TRUE
ddbbbadadcca	TRUE
aaaaaacddcbb	FALSE
aaaaaacdddba	FALSE
aacddcaaddba	FALSE
aacddcbadbda	FALSE
abbbaaddcbdb	FALSE
abbbabbaaada	FALSE
abdcdbadbbac	FALSE
abdcdcbddbca	FALSE
accabbadadba	FALSE
accabcdcadcd	FALSE
adacbadddbdb	FALSE
adacbbdcbacd	FALSE
addabdadbbbb	FALSE
addabddaddbb	FALSE
babbaadbbaaa	FALSE
babbabaaadac	FALSE
bbababbbdcbc	FALSE
bbababbdbabb	FALSE
bbcdabacddba	FALSE
bbcdabccabdd	FALSE
bcbabcdcacbc	FALSE
bcbabdbcbbbd	FALSE
bcdcbdddccab	FALSE
bcdccaaaabaa	FALSE
bdcabcbcddac	FALSE
bdcabdaabadd	FALSE
caacaacaadab	FALSE
caacabbbcaab	FALSE
cadcabbdbddb	FALSE
cadcacdbcddc	FALSE
cbcabcadbbac	FALSE
cbcabcbccbad	FALSE
ccacbccccdab	FALSE
ccacbdaabbdb	FALSE
ccdbbacaadcd	FALSE
ccdbbbaaabcd	FALSE
cdbcdccdadab	FALSE
cdbcddcababc	FALSE
daabbdccdbbd	FALSE
daabbddbadba	FALSE
dadabbaaabcc	FALSE
dadabbadabba	FALSE
dbbdbaacdabd	FALSE
dbbdbaddcdaa	FALSE
dcaadcdcbdba	FALSE
dcabaababbdd	FALSE
dccdccabdaca	FALSE
dccdccadbacd	FALSE
ddbbcdcbadab	FALSE
ddbbcdccacad	FALSE
adadadadadadc	TRUE
adadadadadadc	TRUE
adadcdccdcdbb	TRUE
adadcddbadbad	TRUE
adbbbbbbbbcbb	TRUE
adbbbbcaddcbd	TRUE
adbdcadddcbad	TRUE
adbdcbadadcad	TRUE
adccadccadadb	TRUE
adccadccdadbc	TRUE
addadcdddbdba	TRUE
addaddadadada	TRUE
addcdddbadddd	TRUE
addcdddcbaddc	TRUE
badbbcbddadad	TRUE
badbbccaddcbb	TRUE
baddcdadadccd	TRUE
baddcdbadbdad	TRUE
bbcadcaddbcad	TRUE
bbcadcddadddd	TRUE
bcadcbbbcdadd	TRUE
bcadccadcdcba	TRUE
bcdbccadadcba	TRUE
bcdbccadaddda	TRUE
bdcadbbadcada	TRUE
bdcadbdadddca	TRUE
cadadccbbcadd	TRUE
cadadcccadadb	TRUE
caddaddadccda	TRUE
caddaddcbcdbd	TRUE
cbbccdddcadba	TRUE
cbbcdadadbdca	TRUE
ccadaddbdcdda	TRUE
ccadaddcadadb	TRUE
cccddcbcdadba	TRUE
ccdadadcbbbad	TRUE
cdbcaddadbdba	TRUE
cdbcbbadbcadb	TRUE
dadadbaddcddd	TRUE
dadadbbadadad	TRUE
dadcdcaddbddc	TRUE
dadcdcbccdbdd	TRUE
dbbbccbcdddda	TRUE
dbbbcdccddcdc	TRUE
dcadadbcbadcc	TRUE
dcadadbcdbcca	TRUE
dccdadddcaddd	TRUE
dccdbbadaddca	TRUE
ddbbadadbbbbc	TRUE
ddbbadadcadbb	TRUE
aaaaaacddcbbb	FALSE
aaaaaacdddaaa	FALSE
aacddcccdcaaa	FALSE
aacddccdbbaab	FALSE
abbbaaccabdad	FALSE
abbbaadbbddcd	FALSE
abdcbdcbbbbcc	FALSE
abdccabdacdcc	FALSE
accaadbabaaab	FALSE
accaaddbdbacb	FALSE
adacbbabccbdd	FALSE
adacbbbdaabcd	FALSE
addaacabbacad	FALSE
addaacabcbaac	FALSE
babbcdbcbddad	FALSE
babbdbbcccaad	FALSE
baddcdbacbdad	FALSE
baddcdbcaabbb	FALSE
bbcbdadbadbab	FALSE
bbcbdbdbbacac	FALSE
bcaddcccbcdaa	FALSE
bcadddbdcacad	FALSE
bcdbdbdaabadb	FALSE
bcdbdbdadcbac	FALSE
bdcaaabaaccdb	FALSE
bdcaaadddacbc	FALSE
caacbbababcdb	FALSE
caacbcccdcbda	FALSE
cadabccdbacdb	FALSE
cadabdcbdccdb	FALSE
cbbdcdadaddaa	FALSE
cbbdcdbcbdcaa	FALSE
ccabdbbcdbddd	FALSE
ccabdbddbcdaa	FALSE
cccdcdbaccacb	FALSE
cccddaacabbdb	FALSE
cdbcadbbddbab	FALSE
cdbcbccccbbac	FALSE
daacabbccbacb	FALSE
daacacdbbbabc	FALSE
dadabbcbbadca	FALSE
dadabccbdcccd	FALSE
dbbbddbccabac	FALSE
dbbbdddacacac	FALSE
dcaaacaacdabc	FALSE
dcaaacabdbdbc	FALSE
dccdbcacabbbb	FALSE
dccdbcdadddaa	FALSE
ddbbcdddccbab	FALSE
ddbbdacdccabd	FALSE
adadadadadadad	TRUE
adadadadaddadd	TRUE
adadcdadcdcada	TRUE
adadcdbbbbbbad	TRUE
adbbbdbdcdcdad	TRUE
adbbbdbddadbad	TRUE
adcadadadadadb	TRUE
adcadadadadcba	TRUE
adcccadbbcdbbb	TRUE
adcccadcdccbdb	TRUE
addbadcbddcadc	TRUE
addbadccdadadb	TRUE
adddcdbcbadccc	TRUE
adddcdbdccadbd	TRUE
badcbadadccdca	TRUE
badcbadbdaddad	TRUE
bbaddbdbcddada	TRUE
bbaddcadadcbcd	TRUE
bbdbadcbbadcba	TRUE
bbdbbadadcbcad	TRUE
bccaddcaddbcad	TRUE
bccbadadadbdca	TRUE
bdadcddcbdcbcc	TRUE
bdaddadadaddda	TRUE
bddbdcbcdbbadd	TRUE
bddcadadddadad	TRUE
cadbdcbbadccbc	TRUE
cadbdcdadbbadb	TRUE
cbadbbccbcdbad	TRUE
cbadbbdcadadbb	TRUE
cbcdadbadcadda	TRUE
cbcdadcadcbadd	TRUE
ccbaddccbcbbad	TRUE
ccbaddddbbdada	TRUE
ccddbcbcbbadbc	TRUE
ccddbccddbbddc	TRUE
cdccbadbbadadb	TRUE
cdccbbbbddcbba	TRUE
dadbaddadbbdcd	TRUE
dadbaddbadbcad	TRUE
daddcadadddbad	TRUE
daddcadcadadcc	TRUE
dbcadcbccddddb	TRUE
dbcadcbddadbdb	TRUE
dcadccaddbadbd	TRUE
dcadccbaddadcb	TRUE
dcdadbcadcadbc	TRUE
dcdadbcbadadca	TRUE
ddbbdccbbdbbda	TRUE
ddbbdcccbaddba	TRUE
aaaaaaabadabbd	FALSE
aaaaadcbccdadb	FALSE
aacdcacaabdabd	FALSE
aacdcbacdbcdcc	FALSE
abbccaccadbcca	FALSE
abbccbaaacbcac	FALSE
acaaacbdacdcdc	FALSE
acaaaccdabcdbc	FALSE
acccdaaaccdbdb	FALSE
acccdabcadbdda	FALSE
adbaadbabcbbad	FALSE
adbaadbacbabcd	FALSE
addcaccbdcacdd	FALSE
addcadcacdcaba	FALSE
bacacaadddadac	FALSE
bacaccdbdcddcd	FALSE
bbacdbcadaaacc	FALSE
bbacdbccbcaadb	FALSE
bbdcbcbaabcadd	FALSE
bbdcbcbcdbcacc	FALSE
bccadbdcbcaadb	FALSE
bccaddbddcbbac	FALSE
bdaddcadddacac	FALSE
bdaddcbdcabaac	FALSE
bddcaabacbdcbb	FALSE
bddcaabbdbacbd	FALSE
cacaabdcdbdbbb	FALSE
cacaabddaaccca	FALSE
cbabdcacdbaaba	FALSE
cbabdccaaaacab	FALSE
cbdadbdaccbbcc	FALSE
cbdadccccdaccc	FALSE
ccbccdbadbbcaa	FALSE
ccbcdabbadbbcc	FALSE
cdaabdbbddcaac	FALSE
cdaabddaddcacc	FALSE
cdccadaacacbad	FALSE
cdccadbddabddb	FALSE
dabaddbdcbcadc	FALSE
dabbaaadcdcabc	FALSE
dadcadcaccbbbc	FALSE
dadcbaabcbaadd	FALSE
dbcaaddcabaddb	FALSE
dbcabaadccabca	FALSE
dcaccacdcbbacc	FALSE
dcaccbcbabddac	FALSE
dcdaccbacbbcba	FALSE
dcdacdbaacabcd	FALSE
ddbcdadbdbacba	FALSE
ddbcdadccbcbab	FALSE
adadadadadadccb	TRUE
adadadadadbadcd	TRUE
adadcbcadcdcbad	TRUE
adadcbcdadadbbb	TRUE
adbaddadadcadcc	TRUE
adbaddadadcaddc	TRUE
adbdbadcdadbbca	TRUE
adbdbaddcbdbbda	TRUE
adcbdadcccbdbad	TRUE
adcbdaddaddccca	TRUE
addadbcbdddadbd	TRUE
addadbcdadcdcad	TRUE
adddbcddddbbdad	TRUE
adddbdadaddbbcd	TRUE
badbdaddadbadad	TRUE
badbdbbadbadadd	TRUE
bbadbcdbcaddccc	TRUE
bbadbcddbadbcbd	TRUE
bbcdadadadccada	TRUE
bbcdadaddaddcda	TRUE
bcbcadbbcdbadad	TRUE
bcbcadccdddbadb	TRUE
bdadadcadbbbdbc	TRUE
bdadadcaddadbbb	TRUE
bdccbcdadddadca	TRUE
bdcccadadbbcbdb	TRUE
cadbbbdbbbdcdad	TRUE
cadbbbdcbcdadbc	TRUE
cadddcdbadadcba	TRUE
caddddbbadadbda	TRUE
cbccadadddcbadd	TRUE
cbccadbcbbdadbd	TRUE
ccaddddadcdbadb	TRUE
ccaddddaddddbad	TRUE
ccdbdadbadadbcd	TRUE
ccdbdcccbcaddda	TRUE
cdcadbbadccbdad	TRUE
cdcadbddcaddcbb	TRUE
dadadbddccbcadb	TRUE
dadadcadadaddad	TRUE
daddadcbdbdcadd	TRUE
daddadccdadbbdc	TRUE
dbbdbbdadadcbcc	TRUE
dbbdbbdadbcdadc	TRUE
dcadadddcadcbcb	TRUE
dcadbadbbbcddbd	TRUE
dccdadcadbdaddb	TRUE
dccdadcdadcbbcd	TRUE
ddbbdcbaddadcad	TRUE
ddbbddcdddccada	TRUE
aaaaaaccbabcdcb	FALSE
aaaaabaaabadbbd	FALSE
aaccabbbdbaadbb	FALSE
aaccabcabdbcabc	FALSE
abaccadbccaabbd	FALSE
abacccbbdccaccc	FALSE
abdacadbcaaddac	FALSE
abdacbdabdacadc	FALSE
acbcdcbdddbcbab	FALSE
acbdaaccdccacdc	FALSE
adabdbadabcacda	FALSE
adabddbbccccbdd	FALSE
addbaabcaabcdcd	FALSE
addbaacbcacbcbd	FALSE
babdbccbbabcdcc	FALSE
babdbddababaccb	FALSE
bbacdadcabcccda	FALSE
bbacdbacaabdbad	FALSE
bbdaccbacdddcca	FALSE
bbdacdbacacabdd	FALSE
bcbcccacaabcadc	FALSE
bcbcccbcdbdcabc	FALSE
bdabbbadacbbdad	FALSE
bdabbbdacbadbbd	FALSE
bdcdbcdccbcacbc	FALSE
bdcdbcddbaccbcb	FALSE
cabbcacdcdbbcac	FALSE
cabbcbdaabdabdb	FALSE
cbaadacabddcbcb	FALSE
cbaadbcdccbdccd	FALSE
cbccddcabcdcbdd	FALSE
cbccdddbbdaddac	FALSE
ccbadacacbaddcd	FALSE
ccbadadaaaddcab	FALSE
ccdccdacabdcaab	FALSE
ccdccdbdcacbcdc	FALSE
cdcaaccabdbaadd	FALSE
cdcabbdbdddcadc	FALSE
daaccdcdbacdcbd	FALSE
daacdaadbabcdbb	FALSE
dadbbcaccdcdacb	FALSE
dadbbdbccdacbbd	FALSE
dbbcdaabaddbacd	FALSE
dbbcdaabddccdaa	FALSE
dcaabbdbbcbbddb	FALSE
dcaabdadacdcdad	FALSE
dcccdbbdbbbabdd	FALSE
dcccdbcababdada	FALSE
ddbbbbbccadbcaa	FALSE
ddbbbcabcdbccda	FALSE
adadadadadcbadad	TRUE
adadadadbcadbadd	TRUE
adadccbadadadbbd	TRUE
adadccbadbcdadca	TRUE
adbaddcddaddbbdb	TRUE
adbadddbcdadbadc	TRUE
adbdbbbcbbdcdbad	TRUE
adbdbbddadadcdbc	TRUE
adcbdccbcbadcbcc	TRUE
adccadadadadddad	TRUE
addadaddbdadcadb	TRUE
addadaddbdbcaddc	TRUE
addcbccaddaddcdb	TRUE
addcbcdddbdadbda	TRUE
badaddadbadaddcc	TRUE
badaddadbbcccadb	TRUE
baddaddbbcdddadd	TRUE
baddaddcaddcddbd	TRUE
bbbdadcdcadcdbcc	TRUE
bbbdaddbadadadda	TRUE
bcadbdcadcbbcbad	TRUE
bcadbdcaddbbdadb	TRUE
bccdbdcadbddbdcb	TRUE
bccdcadadbdcdbdb	TRUE
bdbaddcbadccdbcd	TRUE
bdbadddbadaddbba	TRUE
bddddbaddcbbcbbb	TRUE
bddddbbadadadadd	TRUE
cadcbdadaddccada	TRUE
cadcbdaddbdadadb	TRUE
cbbaddcbdbcadcbb	TRUE
cbbbadadcaddbadd	TRUE
cbdcbbbbadccbbad	TRUE
cbdcbcdbbaddbbcd	TRUE
cccbdbadadadbbad	TRUE
cccbdbadadddadba	TRUE
cdbbbddcdcdadbdb	TRUE
cdbbcbbaddbcdadb	TRUE
dadadadadaddadda	TRUE
dadadadadbbadbad	TRUE
dadccccadbbcbbad	TRUE
dadccccdbcaddadd	TRUE
dbbadcadbaddcddd	TRUE
dbbadcadbbdbadbc	TRUE
dbddadbdbddaddbd	TRUE
dbddadccadbddadb	TRUE
dcccbbdccadadadc	TRUE
dcccbccadcadcdad	TRUE
ddbbadadddcadcad	TRUE
ddbbadbbcbbccbda	TRUE
aaaaacbaacddabad	FALSE
aaaabcbbbcbbbabb	FALSE
aaccabbcbbdadddc	FALSE
aaccabbdcddacddc	FALSE
abbacaaadcbcdcda	FALSE
abbacacbbcccbbab	FALSE
abdbdcbddadabbcb	FALSE
abdbdccbaadddcad	FALSE
acbdbbdacddabccd	FALSE
acbdbbdcdbddadad	FALSE
adabacaabccabbdb	FALSE
adabacccadabbdac	FALSE
adcbdcabddcaaacc	FALSE
adcbdcdccacaddda	FALSE
baaddaddbbcbbdba	FALSE
baaddbbdaaacccbb	FALSE
badbacdddbacbcdb	FALSE
badbadcdbaabccac	FALSE
bbbbddcbcbcabdbb	FALSE
bbbcaabbcdabaadb	FALSE
bcaaabdabcdbbaac	FALSE
bcaaabdaddbaddbb	FALSE
bccddbaccacbcbbb	FALSE
bccdddbadabdbcdb	FALSE
bdbbadacccdcdbca	FALSE
bdbbadcaaadcdcbc	FALSE
bdddcdcbdbcbbaaa	FALSE
bdddcddacbdabbcd	FALSE
cacbbdcaadcabcca	FALSE
cacbcbacbdbabacc	FALSE
cbbadbaacadabddb	FALSE
cbbbaacbccbaadca	FALSE
ccaaccccccbaccad	FALSE
ccaadabbbdccaadb	FALSE
cccdbbabbcdbdbad	FALSE
cccdbbdaaabaaadb	FALSE
cdbbddadbdccadac	FALSE
cdbbdddcbbcacbbd	FALSE
daaaacdaadcbdbcc	FALSE
daaaacdaddbdcaca	FALSE
daccaabdcddadbda	FALSE
daccaacbbabcbabc	FALSE
dbbbddaddabbbabd	FALSE
dbbbddbbcdbaadcd	FALSE
dcaaddbdccaccbcc	FALSE
dcaaddcbdddcdbcc	FALSE
dcccadcadacdbdda	FALSE
dcccbaacdccdadbc	FALSE
ddbbdabdaccadccc	FALSE
ddbbdacbdbadabad	FALSE
adadadadadbadbddc	TRUE
adadadadadbcadbca	TRUE
adadccaddddddadad	TRUE
adadccbbcbdaddadc	TRUE
adbbadbddbbaddbcb	TRUE
adbbadcadcadadcdc	TRUE
adbdcbbddadcbdbdd	TRUE
adbdcbcaddadaddcd	TRUE
adccadddcadcbbccd	TRUE
adccbadaddcbcadcc	TRUE
addbadadbadccdada	TRUE
addbadaddadcccbad	TRUE
adddcccdcbdbadccb	TRUE
adddccdadcbcadadd	TRUE
badcadadcbdcbadcc	TRUE
badcadbadccbddbad	TRUE
bbadcadcadbcbbadc	TRUE
bbadcadcadcaddadb	TRUE
bbdadbcddbdcddbad	TRUE
bbdadcadbadbaddcd	TRUE
bcbdcbadadbbadbad	TRUE
bcbdcbddadadbdadb	TRUE
bdadbddadcbadadcd	TRUE
bdadbddaddbbcdcdd	TRUE
bddadadddbaddddbb	TRUE
bddadbbcadcbcbcad	TRUE
cadbcdadddcccdcdd	TRUE
cadbcdbadcadcddbb	TRUE
cbadadccbbbdadadb	TRUE
cbadadccbbcbaddcb	TRUE
cbdadaddcadadaddb	TRUE
cbdadaddcbdddbdbb	TRUE
ccbaddadcaddbadad	TRUE
ccbaddaddaddccdad	TRUE
ccdbdcbcadddcbcdd	TRUE
ccdbddadcdbbddcdb	TRUE
cdbdcbbbcaddadcda	TRUE
cdbdcbbbddddbadbd	TRUE
dadadbdadbdadbadc	TRUE
dadadbdaddcdbddba	TRUE
daddadccbcdccadcd	TRUE
daddadcccadbdadad	TRUE
dbbcadddcadadadcb	TRUE
dbbcbadcadadbaddb	TRUE
dcadbbcbdadadcbbb	TRUE
dcadbbccadadbddcc	TRUE
dcdadadadcbcddbdb	TRUE
dcdadadaddbadbadd	TRUE
ddbcadadcdbdcdadb	TRUE
ddbcadaddbcdbadad	TRUE
aaaaababddcabcabd	FALSE
aaaaabcddddbbdcdd	FALSE
aaccadcadbbcaaabc	FALSE
aaccbaabaaccbacbc	FALSE
abaddacaccaadbaac	FALSE
abaddcbddbabdacbc	FALSE
abdcaababddaacdbd	FALSE
abdcaabbdbddcbaac	FALSE
accadacdacacbccba	FALSE
accadbabdabaaadcb	FALSE
adadacbdbcaadbbab	FALSE
adadadacddddadbaa	FALSE
addccdcdbdabbbdab	FALSE
addccdddaaddcacbd	FALSE
bacbdabddbcaaaccc	FALSE
bacbdcdabddadcdcb	FALSE
bbacbdaaababcbdcb	FALSE
bbacbdadbcaacabdd	FALSE
bbdbaaabacbddbcdc	FALSE
bbdbaacacaddabadc	FALSE
bcbcabaccdccccaaa	FALSE
bcbcabcddbdddccda	FALSE
bdaadadacabbadadc	FALSE
bdaadbbddaacdaacc	FALSE
bddaaacadbcbddcdb	FALSE
bddaadccccbcbaacc	FALSE
cabcdbabdcdbbdbcc	FALSE
cabcdbbdcdcbabadc	FALSE
cadddadaddadcddac	FALSE
cadddcccacddcdadd	FALSE
cbccbdadcdacdcdaa	FALSE
cbccbdadddababcdc	FALSE
ccadcbbcbbabcbddd	FALSE
ccaddaaaabaabbddc	FALSE
ccdbdabcdbdbcbdac	FALSE
ccdbdcdcdbccbabdc	FALSE
cdcabdcccbabcbcaa	FALSE
cdcabddbdabacaabc	FALSE
daacbbbdbcbaabaca	FALSE
daacbbdbbabdcbcbc	FALSE
dadadadadcbadabbb	FALSE
dadadcbaadcacadcc	FALSE
dbbcaadadddcbbbca	FALSE
dbbcabbddcddaabaa	FALSE
dcaaaacdaddcadadc	FALSE
dcaaacacccbadaaaa	FALSE
dccdacabdacccdcca	FALSE
dccdaccddcbdbdaad	FALSE
ddbbcacacdbccdbdb	FALSE
ddbbcbadadbcacddc	FALSE
adadadadadadcdcada	TRUE
adadadadadaddcbddd	TRUE
adadcbbdcadbadcbad	TRUE
adadcbcadaddcdadcd	TRUE
adbaddbaddddbcbdda	TRUE
adbaddbbbbadadbadd	TRUE
adbdadcdcadbadbadc	TRUE
adbdadcdccccdcbada	TRUE
adcbcbdadcadccadbc	TRUE
adcbcbddadccadadca	TRUE
adcddaddddcccbadad	TRUE
adcddbadadadccdcad	TRUE
addccccadbcdccdbca	TRUE
addccccbdbadbdbadb	TRUE
badbccdcccdbcddcdd	TRUE
badbcdaddcadaddada	TRUE
bbadccadcbbadbbcbc	TRUE
bbadccbcadbbdadcad	TRUE
bbdadcdbcbdbcaddbd	TRUE
bbdadcdddddcbadbdb	TRUE
bcbdcbcadcbaddbbba	TRUE
bcbdcbcddbddcaddcd	TRUE
bdadcadadadbdaddcb	TRUE
bdadcadccadcbccdca	TRUE
bdcdadadcadccdccca	TRUE
bdcdadadcbbbadcadb	TRUE
cadbadcdcbdddbbada	TRUE
cadbadcddbadaddcdb	TRUE
caddcdbadadccadadb	TRUE
caddcdbbbdbbadccdb	TRUE
cbcbbdbbaddbbdcddb	TRUE
cbcbbddcdcbadadada	TRUE
ccbadadbcbcbbbcadc	TRUE
ccbadaddbdbbbdadca	TRUE
ccdcbcbadbccddcbad	TRUE
ccdccbadddcdddbbba	TRUE
cdcbcdadccbbddadad	TRUE
cdcbcdadcdadadcbbd	TRUE
dadadddbdbcadcbadd	TRUE
dadbadadadccadbdad	TRUE
daddbdaddddadbcadb	TRUE
daddbdcccadadbbdbb	TRUE
dbbdcbddbcbbbadcba	TRUE
dbbdcccbbbadcadbcd	TRUE
dcadccbcbcbdadcccd	TRUE
dcadccbdbbdbadbdad	TRUE
dccdddadadadadadad	TRUE
dcdadadadbcbddcbbd	TRUE
ddbbdddcbccadadcad	TRUE
ddbcadaddbadcbadad	TRUE
aaaaaacdcaacbdddad	FALSE
aaaaaadcadbdbddbcb	FALSE
aacbadaacbcaabdcdb	FALSE
aacbadcdadcccaccbb	FALSE
abadbaccaccddadaad	FALSE
abadbacdccdacbacdb	FALSE
abdabcdcbacbbcbdbb	FALSE
abdabdccaadabcaaad	FALSE
acbbdcdcaadcbdacba	FALSE
acbcabbbaddcadaacd	FALSE
acddbccbdbddcdacdd	FALSE
acddbcddadcaadcbca	FALSE
adccdaadcdddaaccdb	FALSE
adccdaadddbbadbcdc	FALSE
babcdcbdbbdbdacacd	FALSE
babcddbbbcbaabbdaa	FALSE
bbabdbddadaccadaab	FALSE
bbabddabcdcdcbadbb	FALSE
bbcdacbcdaccccdaca	FALSE
bbcdaccbccddbcbcbb	FALSE
bcbbdcaacbbcaccabb	FALSE
bcbbddcccabdabacda	FALSE
bdaadcbabbccdaddbc	FALSE
bdaaddbdcdcacdadcb	FALSE
bdcccbdadddcccaacb	FALSE
bdcccbddadbbdcddab	FALSE
cabbbaaccacacdbaad	FALSE
cabbbaddabacccadcb	FALSE
cbaacccdabaabacbcd	FALSE
cbaadcbbbbdccaabdb	FALSE
cbcccbbbccadcaacaa	FALSE
cbcccbbcacccccddcb	FALSE
ccbbabddcadaccbdca	FALSE
ccbbbbbdacbdddcdca	FALSE
ccdddcbcbccabdbdcc	FALSE
ccdddcdcddadbccdab	FALSE
cdcbaddcabadbccaaa	FALSE
cdcbbbabdadbcddcdc	FALSE
daadaadcccabbbcdcd	FALSE
daadabcccadadcbbdc	FALSE
dadacaadabbcadbddb	FALSE
dadacbcbbcdddccacd	FALSE
dbbddbabbabadbcdac	FALSE
dbbddccbbbacccadbb	FALSE
dcabbcadcdabbbdbad	FALSE
dcabbdcddabddbdabc	FALSE
dcccdacbcbccdcaabc	FALSE
dcccdbbddadbaabada	FALSE
ddbbacdddadcdcddbb	FALSE
ddbbaddcbacbaabbcd	FALSE
adadadadadadadadcdc	TRUE
adadadadadadadcbdad	TRUE
adadccadadcbadcdddd	TRUE
adadccadbadcdbdaddc	TRUE
adbaddcbaddadbdddbb	TRUE
adbaddccadddbbcccdd	TRUE
adbdbccdccadddadadc	TRUE
adbdbcdbbbbadcadada	TRUE
adccadaddbdcdbbdadb	TRUE
adccadbadbcdadcdcdd	TRUE
addaddbadbcbdbdadca	TRUE
addaddbbadcbdbbadbc	TRUE
adddcadddcbbadcbdcc	TRUE
adddcbbbadcadcadcad	TRUE
badcadbcdadcbbdbbad	TRUE
badcadcaddaddbadcbd	TRUE
bbadddcbadbbbdbadcb	TRUE
bbadddccbcadddadadb	TRUE
bbdcadbbcdbbcadadcc	TRUE
bbdcadcadadcadadcad	TRUE
bccadaddbbdadbdbdad	TRUE
bccadbbdadbbadcbdbd	TRUE
bdadbdaddccadccbadc	TRUE
bdadbdbbddbbbdadcda	TRUE
bddadadaddadcadcbda	TRUE
bddadadaddcaddbadbb	TRUE
cadbbdcbbadbdbcadcb	TRUE
cadbcadadcaddaddbad	TRUE
cbadadcbaddadbbadda	TRUE
cbadadcbbadcbdaddbb	TRUE
cbcdbadbadbbadadccc	TRUE
cbcdbadcdcbbccadcdd	TRUE
ccbbccccaddaddcbbad	TRUE
ccbbccdadcdcaddcbda	TRUE
ccdddadadbcadccadcd	TRUE
ccdddcbbdbcaddcbbda	TRUE
cdcbadadadcbadcdbad	TRUE
cdcbadbdcadadadadad	TRUE
dadbadadbdadbadddbb	TRUE
dadbadadccadadcbdda	TRUE
daddcdccccadbadbbad	TRUE
daddcddadadadadcdad	TRUE
dbccadadbdcaddbcada	TRUE
dbccadaddbbbbbbbbda	TRUE
dcaddcdbadcddadadad	TRUE
dcadddadcadcadccadd	TRUE
dcdcadcadbadcaddddd	TRUE
dcdcbbdbaddadddddcd	TRUE
ddbdcadbadbadcadadc	TRUE
ddbdcadbcaddadcadbc	TRUE
aaaaaaaacdcbdabbbab	FALSE
aaaaaaaccabdcbbacca	FALSE
aaccbdbbbabbdccdbcb	FALSE
aaccbdbcbabbcdbbdaa	FALSE
abbaabdcbaabdaddacb	FALSE
abbaacbcccdccbddddc	FALSE
abdbdcabccdcbbbcdac	FALSE
abdbdcacddbabdddacb	FALSE
acbdbdaddbbccadcdba	FALSE
acbdbdccddcbdddabad	FALSE
adacddddcbccaadacdb	FALSE
adadaaacabacbbcdaaa	FALSE
addbccbdacbbacabbba	FALSE
addbcdccdcbddcddbaa	FALSE
bacadcbcdcaccacaccd	FALSE
bacadcdcbbcbbbcabba	FALSE
bbadbdaccbabbacbcbb	FALSE
bbadbdcccdabdadccbd	FALSE
bbdbddaadcbacddbddd	FALSE
bbdbddaddbabcabdccc	FALSE
bcbcdacdabbcddbbccc	FALSE
bcbcdbaadadbaabaaab	FALSE
bdababcabddcacccbda	FALSE
bdabaccccdbbcdbdacb	FALSE
bdcccccacacabdbcdcb	FALSE
bdccdabccdabdaacadd	FALSE
cabcdddcbcacaacabbd	FALSE
cabdabbadadaabdbcac	FALSE
cbaacbdacbacbaccbbc	FALSE
cbaaccacadaccadbdad	FALSE
cbcccbcaacdcabadbaa	FALSE
cbcccbddddcacbaddca	FALSE
ccbadaacdcabbccbaac	FALSE
ccbadababbcdbcadbdd	FALSE
ccddbaccbbbccdcbdaa	FALSE
ccddbbdbbcadbbcddac	FALSE
cdcbcbacbadabdbabca	FALSE
cdcbcdbcdbbdabdbbcd	FALSE
dabaaabbabddabdcaad	FALSE
dabaabaccabcdabbaab	FALSE
dadcaaabacbddbdaadc	FALSE
dadcaaacccccbcddbcb	FALSE
dbcaaaacabbcdaadcdd	FALSE
dbcaaababbcdaaaddba	FALSE
dcabdbbcacaddaaabad	FALSE
dcabdcabdddbabdadba	FALSE
dcdaacbddcdaabbcada	FALSE
dcdaadbcdcdcbcdccba	FALSE
ddbccaacccaadaddcab	FALSE
ddbccaadbababbcadcc	FALSE
