aaaaaaaddb	TRUE
aaaaaabccc	TRUE
aabcdcadbc	TRUE
aabcdcadbc	TRUE
aadcdbcddb	TRUE
aadcdbcddd	TRUE
acbccdcdad	TRUE
acbccdcdcb	TRUE
acdcbcaabc	TRUE
acdcbcaccb	TRUE
adbccaacdc	TRUE
adbccacbcd	TRUE
addcadcbcd	TRUE
addcaddbcd	TRUE
bcacbcbcbc	TRUE
bcacbcbccb	TRUE
bcbcaacbca	TRUE
bcbcaacbcb	TRUE
bcbccdaaad	TRUE
bcbccdaabc	TRUE
bccbcbccaa	TRUE
bccbcbccbc	TRUE
bcdaaaccbc	TRUE
bcdaaaccbc	TRUE
bcdcdadbcd	TRUE
bcdcdadcbc	TRUE
cacaadcbca	TRUE
cacacaacaa	TRUE
caddccbcdb	TRUE
caddcdacda	TRUE
cbcccdcccc	TRUE
cbcccddbcb	TRUE
ccbcacbcbc	TRUE
ccbcacbccb	TRUE
ccdbcdcccd	TRUE
ccdbcdccdd	TRUE
cdcacbcacc	TRUE
cdcacbcbcc	TRUE
daacdbcadc	TRUE
daacdbcdac	TRUE
dadcacdaab	TRUE
dadcacddcd	TRUE
dbcbcdcddc	TRUE
dbcbcddacc	TRUE
dcacadcdbc	TRUE
dcacbcaabc	TRUE
dcdaabcddc	TRUE
dcdaadbcac	TRUE
ddbcbccadd	TRUE
ddbcbccbcc	TRUE
aaaaaaaaab	FALSE
aaaaaacbdb	FALSE
aaccaccdbb	FALSE
aaccbaacdc	FALSE
abacdbdaac	FALSE
abacdcbaaa	FALSE
abdbcddacb	FALSE
abdbdabccd	FALSE
acbddabbdd	FALSE
acbddacbdd	FALSE
adaddadcab	FALSE
adaddbaddc	FALSE
addbaaccdc	FALSE
addbaddabb	FALSE
babcddcddd	FALSE
babdaaaaba	FALSE
bbaadccaad	FALSE
bbaadcddbd	FALSE
bbcdcddbca	FALSE
bbcddadaac	FALSE
bcbbadbbaa	FALSE
bcbbbaaaad	FALSE
bcddcadcbb	FALSE
bcddcbacbd	FALSE
bdccdcbaca	FALSE
bdccdcdacd	FALSE
cabbbbdadc	FALSE
cabbbbdcdd	FALSE
caddcbbbbd	FALSE
caddcddcab	FALSE
cbcdacaaab	FALSE
cbcdacdabb	FALSE
ccbacacaad	FALSE
ccbacbccbd	FALSE
ccdbdcacab	FALSE
ccdbdccdad	FALSE
cdcabdbbab	FALSE
cdcacaaaba	FALSE
daadcabbbd	FALSE
daadcbaaab	FALSE
dadbbaddab	FALSE
dadbbbbddd	FALSE
dbbdcbbaca	FALSE
dbbdcbbdbd	FALSE
dcabcddcbd	FALSE
dcabdbccdc	FALSE
dcdabcdcdc	FALSE
dcdabdbdad	FALSE
ddbbbccdbd	FALSE
ddbbbdacca	FALSE
aaaaaaacbcd	TRUE
aaaaaabcaca	TRUE
aacaabcdccc	TRUE
aacaabcdddb	TRUE
aaddbccbcdb	TRUE
aaddbcdaabc	TRUE
acbcdaddbca	TRUE
acbcdbcacac	TRUE
acdcadcdadc	TRUE
acdcbcacdac	TRUE
adbccbcdbcb	TRUE
adbccbcdbcc	TRUE
addbcdbcbcc	TRUE
addbcddbccb	TRUE
bcacbcdcbca	TRUE
bcacbcddcbc	TRUE
bcbcacdbcbc	TRUE
bcbcacdbcdb	TRUE
bcbcdbcbcda	TRUE
bcbcdbcbcdd	TRUE
bccbcdbcbcd	TRUE
bccbcdbccad	TRUE
bcdaacadadd	TRUE
bcdaacbcadc	TRUE
bcdcdaaacac	TRUE
bcdcdaaadaa	TRUE
caadadddadc	TRUE
caadbcadadd	TRUE
caddaaddddd	TRUE
caddacacddc	TRUE
cbccbcbccdd	TRUE
cbccbcbcdac	TRUE
ccadcbcdbcb	TRUE
ccadcbcddbc	TRUE
ccdcbcaabcb	TRUE
ccdcbcacdbc	TRUE
cdbcdcdadcb	TRUE
cdbcdcdcbca	TRUE
daaaccbcaac	TRUE
daaacccbcaa	TRUE
dadadbcdcbc	TRUE
dadadcacadb	TRUE
dbcbcbcccdd	TRUE
dbcbcbcccdd	TRUE
dbcddaddaaa	TRUE
dbcddaddacc	TRUE
dccccacdbcc	TRUE
dccccbcdddc	TRUE
ddbcacbcdcb	TRUE
ddbcaccbcbc	TRUE
aaaaaaabdbc	FALSE
aaaaabbcdba	FALSE
aacccadabdd	FALSE
aacccaddaba	FALSE
abbadaabdca	FALSE
abbadabbccd	FALSE
abddbbddbaa	FALSE
abddbccdbbd	FALSE
accabcbadbd	FALSE
accacaaadba	FALSE
adacaddddba	FALSE
adacbadacab	FALSE
addbbabbccb	FALSE
addbbbbbbbc	FALSE
babdccccddd	FALSE
babdccdbcdd	FALSE
bbaaaddbbdc	FALSE
bbaabbddbcc	FALSE
bbccdbbacad	FALSE
bbccdccdbca	FALSE
bcbabbccaba	FALSE
bcbabdbbcca	FALSE
bcddcbbaddb	FALSE
bcddcbcddab	FALSE
bdccbdaccca	FALSE
bdccbdbabcb	FALSE
cabacbdbbcc	FALSE
cabaccabbcc	FALSE
cadccadcdab	FALSE
cadccccccab	FALSE
cbcbcaaddbd	FALSE
cbcbcabcccc	FALSE
ccadcadbdad	FALSE
ccadcbbcbcd	FALSE
ccdcbaacbcb	FALSE
ccdcbaccaba	FALSE
cdbdcbcdbad	FALSE
cdbdcdadacd	FALSE
daaacabaccb	FALSE
daaacbcadbd	FALSE
dacdcabdcab	FALSE
dacdcbaaadd	FALSE
dbbccbabddd	FALSE
dbbccbacddd	FALSE
dbddadbdcaa	FALSE
dbddbbbdcbc	FALSE
dccccacdbbc	FALSE
dccccbadddc	FALSE
ddbacbbabda	FALSE
ddbaccabbaa	FALSE
aaaaaaacbcdd	TRUE
aaaaaabcbcbc	TRUE
aacaacaadcbc	TRUE
aacaacbccbcc	TRUE
aaddadcbccad	TRUE
aaddbcacdbca	TRUE
acbcdaaacbcd	TRUE
acbcdacbcdcb	TRUE
acdbcdcdcbcd	TRUE
acdbcddacccc	TRUE
adbccaacadcc	TRUE
adbccaaddddc	TRUE
addbcdbccbcb	TRUE
addbcddaccac	TRUE
bcacbcbcdaaa	TRUE
bcacbcbcdbcc	TRUE
bcbcaaccbcbc	TRUE
bcbcaacccdac	TRUE
bcbccdaccadb	TRUE
bcbccdbcaacd	TRUE
bccbcbccacac	TRUE
bccbcbccccdc	TRUE
bcdaabcaadac	TRUE
bcdaabcacadc	TRUE
bcdcbcbcbcad	TRUE
bcdcbccaccbc	TRUE
caadcdbcdcbc	TRUE
caaddaccdccc	TRUE
cadcdbcdcdda	TRUE
cadcdcacdbcb	TRUE
cbccacdacdda	TRUE
cbccacdcdaac	TRUE
ccadaadbcbcc	TRUE
ccadaccbcadd	TRUE
ccdaacdbcbca	TRUE
ccdaadbcbcdc	TRUE
cdbccbcbcacb	TRUE
cdbccbcbccca	TRUE
daaadaabcbcd	TRUE
daaadaddddad	TRUE
dadbcaddccaa	TRUE
dadbcbcacdcc	TRUE
dbcbcdbccaad	TRUE
dbcbcdbccacb	TRUE
dcacdccdcdda	TRUE
dcacddbcbcbc	TRUE
dcdacbcadbcc	TRUE
dcdacbccbcdd	TRUE
ddbcbcdddcbc	TRUE
ddbccaabcadd	TRUE
aaaaaacaabaa	FALSE
aaaabbaacaab	FALSE
aacdcbbadcba	FALSE
aacddaadcabc	FALSE
abbbdabacccb	FALSE
abbbdacbcdbb	FALSE
abddccbbcaab	FALSE
abddcddaadac	FALSE
acccbbbddaba	FALSE
acccbbddbdbb	FALSE
adadbccbdccd	FALSE
adadbdaccccc	FALSE
addacadcbcba	FALSE
addacbaadbcd	FALSE
babcdacacadc	FALSE
babcdadbccdc	FALSE
bbaaaacdbcdd	FALSE
bbaaaadbccdb	FALSE
bbccccbbbbbd	FALSE
bbccccbcdcac	FALSE
bcbacdaaccad	FALSE
bcbacdabcacd	FALSE
bcddacbbcbdc	FALSE
bcddadcadcab	FALSE
bdcbcbabdccd	FALSE
bdcbcdaaabba	FALSE
cabacbaabacd	FALSE
cabacbacabdb	FALSE
cadcbadddacc	FALSE
cadcbbbcdddd	FALSE
cbcaabaababb	FALSE
cbcaabdabbcb	FALSE
ccacbddbcdda	FALSE
ccaccaabdbdb	FALSE
ccdabdabbdaa	FALSE
ccdabdbaabdd	FALSE
cdbdaaabbbaa	FALSE
cdbdaabbbdcc	FALSE
daabacbbccac	FALSE
daabacddaadd	FALSE
dacdabcdcddd	FALSE
dacdacabcaac	FALSE
dbbcbbacccac	FALSE
dbbcbcdbdcad	FALSE
dcaabbbbacba	FALSE
dcaabbcdcdcb	FALSE
dcccdcbbccad	FALSE
dcccddabacca	FALSE
ddbcbabcddbb	FALSE
ddbcbbcbbdad	FALSE
aaaaaaaaaaaac	TRUE
aaaaaaadbcdbc	TRUE
aacaacacdadbc	TRUE
aacaadacbcbcc	TRUE
acaabccddbcbc	TRUE
acaabcdddcbca	TRUE
acbcdddbcaacd	TRUE
acbcdddcbcbca	TRUE
acdcccddcdcaa	TRUE
acdccdacdaacd	TRUE
adbccadddcbca	TRUE
adbccbcaabccc	TRUE
addbcccacaaca	TRUE
addbccdbcbcda	TRUE
bcacbcdbcadcc	TRUE
bcacbcdbcccdd	TRUE
bcbcacaacdcdd	TRUE
bcbcacadaccad	TRUE
bcbcccddbccac	TRUE
bcbcccddbcdda	TRUE
bccbcadbcbccc	TRUE
bccbcadbcbcdd	TRUE
bccdddcdcaadc	TRUE
bccddddaacbcb	TRUE
bcdccdcddaddb	TRUE
bcdccddaadcca	TRUE
caaddaadcdadc	TRUE
caaddcccdccca	TRUE
cadddaadbcbcb	TRUE
cadddacacaccc	TRUE
cbccbcbcddaca	TRUE
cbccbccbccaaa	TRUE
ccaddbcccacdc	TRUE
ccaddcaaaadaa	TRUE
ccdcacaadddcc	TRUE
ccdcacadcadbc	TRUE
cdcacbcdbcdac	TRUE
cdcacbcdbcdda	TRUE
daaadaccdbcda	TRUE
daaadadadcbca	TRUE
dadadaadcadbc	TRUE
dadadacaaccac	TRUE
dbcbccbccdaab	TRUE
dbcbccbcdaacb	TRUE
dcacacbccbcbc	TRUE
dcacacccddcbc	TRUE
dccdaddbcacda	TRUE
dccdbcacdadad	TRUE
ddbcbcbcbccbc	TRUE
ddbcbcbcccbcb	TRUE
aaaaaacaabaab	FALSE
aaaabaaacaabb	FALSE
aacdbddcbcaaa	FALSE
aacdcbbbabdbd	FALSE
abbbdbacacacb	FALSE
abbbdcaccdccd	FALSE
abddcdaacdaaa	FALSE
abddcdbcdbdbd	FALSE
accbcbccbabbb	FALSE
accbcbdbcbbdd	FALSE
adadacdcaacab	FALSE
adadadbcbaaad	FALSE
addbabadabaac	FALSE
addbacadbabab	FALSE
babdbbcdcbaad	FALSE
babdbbcdcccbc	FALSE
bbabcdaccbcdb	FALSE
bbabdaabdacdb	FALSE
bbcdbbcdabcca	FALSE
bbcdbcdbcbbcb	FALSE
bcbbdaabbbcab	FALSE
bcbbdcdadcbac	FALSE
bdaabdcdccdcd	FALSE
bdaabddabdccd	FALSE
bdcdcabbdabbd	FALSE
bdcdcaccbaacc	FALSE
cabbaddaddbac	FALSE
cabbaddddbabc	FALSE
caddccccacbdb	FALSE
caddcdabbccac	FALSE
cbcbdcdbaadca	FALSE
cbcbddbdadcda	FALSE
ccaddadccacbd	FALSE
ccaddbcabaaba	FALSE
ccdcabbaddddd	FALSE
ccdcabdcccadb	FALSE
cdcabadcddada	FALSE
cdcabcbadcdcd	FALSE
daabadcdccbda	FALSE
daabbccbbcdcb	FALSE
dadaaaddbbcdb	FALSE
dadaacabbdcbc	FALSE
dbbcdaadaabac	FALSE
dbbcdaadaacaa	FALSE
dcabbcbbbaaad	FALSE
dcabbdcddaaab	FALSE
dccdadabdabda	FALSE
dccdbaddcbdad	FALSE
ddbbbadbddaca	FALSE
ddbbbbbddbbda	FALSE
aaaaaaaadcaacd	TRUE
aaaaaabcbccadd	TRUE
aacaaaadadbcca	TRUE
aacaaadbcbccad	TRUE
aadccccbccbcbc	TRUE
aadcccdcdcbcda	TRUE
acbccddcbcbcaa	TRUE
acbcdaacbcbccb	TRUE
acdcacadbcaadc	TRUE
acdcacbcaabcac	TRUE
adbcbcdcbccaac	TRUE
adbcbcdccadacc	TRUE
addbcbccbcbcca	TRUE
addbcbcccdcbcb	TRUE
bcacbccdaadacd	TRUE
bcacbcdaaaaadb	TRUE
bcbcacadaabcac	TRUE
bcbcacadbcbcbc	TRUE
bcbcdbcaddadca	TRUE
bcbcdbcaddbcbc	TRUE
bcccaaacbcacbc	TRUE
bcccaaaddbcddd	TRUE
bcdaadcadcaccc	TRUE
bcdaaddccbcbcd	TRUE
bcdcdcadadbcca	TRUE
bcdcdcadbcbcdd	TRUE
cacadacdadccdd	TRUE
cacadbcadadbcc	TRUE
cbcaaaccbcbcbc	TRUE
cbcaaacdddcbca	TRUE
cbccccdaacccda	TRUE
cbcccdbcdadbca	TRUE
ccbcaddcbcbcdc	TRUE
ccbcbcaacdbccc	TRUE
ccdcdaaacbcadb	TRUE
ccdcdaabcbcddc	TRUE
cdcbcaabcbcdbc	TRUE
cdcbcaadbcacad	TRUE
daacbccacdaaad	TRUE
daacbccbccbcdd	TRUE
dadcaabcccacaa	TRUE
dadcaadccccbca	TRUE
dbcbccdadcdbcb	TRUE
dbcbccdbcbccdd	TRUE
dcacbccacddbca	TRUE
dcacbccadcbcdb	TRUE
dcdadaccaacdbc	TRUE
dcdadacccaacbc	TRUE
ddbcbcdcacccdc	TRUE
ddbcbcdcbcdacc	TRUE
aaaaaabadcabcc	FALSE
aaaaabdcbcccba	FALSE
aaccccbcdbccab	FALSE
aacccccaacbcab	FALSE
abaddaabacdcbc	FALSE
abaddaabdabaab	FALSE
abdbbacabbbbaa	FALSE
abdbbbaabbdacd	FALSE
acbdcbcacacdcc	FALSE
acbdcbdcbbbadb	FALSE
adabddbcddcacc	FALSE
adacaaaaaadcab	FALSE
adcddddbbbabcb	FALSE
adcddddcbdcddc	FALSE
babccabcdbbaca	FALSE
babccaddbcdcbc	FALSE
bbabcbdcbbdbaa	FALSE
bbabccadadcbbb	FALSE
bbdacddaaaaadc	FALSE
bbdadbdddacdbc	FALSE
bcbccaaddbabbc	FALSE
bcbccbbbdbcbbd	FALSE
bdabaabcabdabd	FALSE
bdabaadbaacbba	FALSE
bdccadcddadbab	FALSE
bdccbcbabbcaab	FALSE
cabcabcdabaabc	FALSE
cabcacccbbcaab	FALSE
cbaaadbbdbadab	FALSE
cbaaadcabacdca	FALSE
cbcdcbbbbbacac	FALSE
cbcdcbcdbaabbd	FALSE
ccbaddacdcadcd	FALSE
ccbaddadbdcbdb	FALSE
ccdcdaaacbbadb	FALSE
ccdcdaabdbaddc	FALSE
cdcbabadaccadb	FALSE
cdcbabdcadbdbd	FALSE
daadaabdadbadc	FALSE
daadaacaacbddc	FALSE
dadacccadacbac	FALSE
dadacdaccaaabd	FALSE
dbbdbbacabbaad	FALSE
dbbdbbdddabdbc	FALSE
dcabdabaccaabd	FALSE
dcabdbabbcabcb	FALSE
dcdadabcdccacd	FALSE
dcdadacadaacab	FALSE
ddbcaaacdcdcbd	FALSE
ddbcaacbbababa	FALSE
aaaaaaacbcbccda	TRUE
aaaaaaadcbcbccb	TRUE
aacaabcbcaddcbc	TRUE
aacaacbccdbccac	TRUE
aaddcbccdbcdaab	TRUE
aaddccbcddbcdbc	TRUE
acbcdaadbcaddbc	TRUE
acbcdacaadacbcc	TRUE
acdbcddbccbcddb	TRUE
acdbcddcbcacdbc	TRUE
adbcbcaacaabcbc	TRUE
adbcbcaadddcbca	TRUE
addadbcbccdbcdd	TRUE
addadcaccbcbccc	TRUE
bcacadadcbccaca	TRUE
bcacadbcaccacaa	TRUE
bcadddcbcadaccd	TRUE
bcadddccdbcacaa	TRUE
bcbccbccbcbccbc	TRUE
bcbccbcccdbcccc	TRUE
bccbcaabccacddb	TRUE
bccbcaacadbcbcc	TRUE
bccdcdccdacdcdd	TRUE
bccdcdcdbcaadcd	TRUE
bcdcacaabccaaad	TRUE
bcdcaccaaacbcaa	TRUE
caabccbcbccccad	TRUE
caabcccadcbcacb	TRUE
cadbcdacbcdbcbc	TRUE
cadbcdaddcadbca	TRUE
cbcbcccbcaaacca	TRUE
cbcbcccbcbcbccc	TRUE
ccaabcadbcccacd	TRUE
ccaabcbcaddddad	TRUE
cccccbcbcdadcdb	TRUE
cccccbccadcbcad	TRUE
cdbcbcbcbcadbcd	TRUE
cdbcbcbccaddccc	TRUE
cddcccbccbcccdb	TRUE
cddcccdcaabcdda	TRUE
dacdbccadaddacc	TRUE
dacdbcdcaccbcbc	TRUE
dbcbcbcaacdbcaa	TRUE
dbcbcbcaadbccad	TRUE
dbcddddbcbcbcdc	TRUE
dbcddddbccbcadb	TRUE
dcccbcccbcacddc	TRUE
dcccbcdbccbcbcc	TRUE
ddbcadbcbcaccac	TRUE
ddbcadcbcaadbcd	TRUE
aaaaaaacaaacabc	FALSE
aaaaabdaabdddad	FALSE
aacccaccaddacab	FALSE
aacccbdbdbddcbd	FALSE
abbacdacdacaaca	FALSE
abbadabbbbcdcdc	FALSE
abddbdbcbadbcaa	FALSE
abddbddccadbada	FALSE
accacacccdcabcd	FALSE
accacdccbbbddbc	FALSE
adabcccbdccdbcd	FALSE
adabcddabcaadad	FALSE
addaabbdcdcbdbb	FALSE
addaacbcdadadab	FALSE
babcbcabccabcca	FALSE
babcbccaacadaba	FALSE
bbaaccadccccccb	FALSE
bbaaccbbcdacbbd	FALSE
bbcdbbccddddbca	FALSE
bbcdbddccadccab	FALSE
bcbcbdababbdacb	FALSE
bcbcbddadbabbbd	FALSE
bdabbdcccabccdc	FALSE
bdabcbccabaacba	FALSE
bddaaacbbdadbdd	FALSE
bddaaacdddcdcbc	FALSE
cabdbcacbccdbda	FALSE
cabdbcbdabacbbd	FALSE
cbabdbbdcbcbada	FALSE
cbabdcbaaaaabbd	FALSE
cbdaababddadaac	FALSE
cbdaabcabcdccbb	FALSE
ccbacdadacdacaa	FALSE
ccbaddbbacbcabc	FALSE
ccdccabdadcabab	FALSE
ccdccbbcbadbcca	FALSE
cdcacaccbbcadbd	FALSE
cdcacbacaddbaca	FALSE
daabdcbacbcdabb	FALSE
daabdcdcaababad	FALSE
dadbaacccaabcda	FALSE
dadbaadccddcaad	FALSE
dbcabcabdccaaaa	FALSE
dbcabcdabcbabad	FALSE
dcabcdabdcaabab	FALSE
dcabdadaadabbbc	FALSE
dcdabcbdbbdcddd	FALSE
dcdabccbddcacab	FALSE
ddbcadbabbcadaa	FALSE
ddbcbdaadabadca	FALSE
aaaaaaadcdcbcbcd	TRUE
aaaaaabcaabccaad	TRUE
aacaabcbcdbcacbc	TRUE
aacaabcdadacbccc	TRUE
acaaadddcbcbcbcc	TRUE
acaabcaccdadcbcb	TRUE
acbcdaddccaaadaa	TRUE
acbcdbcadadcdaac	TRUE
acdcbcbcdaabcdac	TRUE
acdcbccccdcddbcb	TRUE
adbcbcbcadbcaacc	TRUE
adbcbcbcadbcdcdc	TRUE
addaccaabcddbcbc	TRUE
addaccaddacbcaca	TRUE
bcacaacdaadbcbcd	TRUE
bcacaacdcadcdacb	TRUE
bcbcaabcaccdbcac	TRUE
bcbcaabcadbcccbc	TRUE
bcbccdcbcbcaaada	TRUE
bcbccdccacaacdda	TRUE
bccbccadcaadcacb	TRUE
bccbccbcdadbcaab	TRUE
bcdacbcddcaaccac	TRUE
bcdaccacaccaccbc	TRUE
bcddacdbcbcadddc	TRUE
bcddacdbccccdcad	TRUE
cacbcaddacbcadda	TRUE
cacbcaddbcbccaab	TRUE
cbcacdbcdbcbcbcd	TRUE
cbcacdbcdcdaadbc	TRUE
cbcdadccccaabcdc	TRUE
cbcdadccdddbcacb	TRUE
ccbcdcdaaacddcda	TRUE
ccbcdcdadaadcaac	TRUE
ccddcaacddddcadc	TRUE
ccddcadcdcbcdaca	TRUE
cdcbcacbcbcdcccd	TRUE
cdcbcaddaacddadd	TRUE
daabccbcbcdcccac	TRUE
daabccbcccdadbca	TRUE
dadadcadaacdcaac	TRUE
dadadcbcdddaacac	TRUE
dbcbcadcccbcbcbc	TRUE
dbcbcadddbcdbccc	TRUE
dcaaaacaabcdbcdc	TRUE
dcaaaacadcaaaada	TRUE
dcccbcddaabccdbc	TRUE
dccccaabcaccbcdb	TRUE
ddbcaddbcdbcbcac	TRUE
ddbcaddcddddadcb	TRUE
aaaaaaadcadaccba	FALSE
aaaaaaccdacabaad	FALSE
aaccbdcadacbbbda	FALSE
aacccaacbcabdbdb	FALSE
abadbbccbdbcbbbd	FALSE
abadcabaccddcdcb	FALSE
abdbddcbcadcdcaa	FALSE
abdbddddabacdbdb	FALSE
accaabcdabdbcbdd	FALSE
accaabcdcddcddbd	FALSE
adabdcbbcdbcdcbb	FALSE
adabdccdbddadbdd	FALSE
adcdccbabbaacbcb	FALSE
adcddadaaadacdbb	FALSE
babdabaddbcbccdd	FALSE
babdabdbcdabcbdc	FALSE
bbaacccbdcdcacad	FALSE
bbaacccdaddccdaa	FALSE
bbcdcdccbbddbabd	FALSE
bbcddaababdbcabd	FALSE
bcbacdddbcbaadcd	FALSE
bcbadaabddacdddc	FALSE
bcddbccdabddcbcd	FALSE
bcddbdbcbbadbdbc	FALSE
bdcccccbdcddddca	FALSE
bdcccdaadbaccbbc	FALSE
cabadcadaacccaca	FALSE
cabbaabdacdaadba	FALSE
caddbcbcbabbddda	FALSE
caddcababddbbbdb	FALSE
cbcadabacaabadca	FALSE
cbcadabdcbddccbd	FALSE
ccadcbcdbdccdcdc	FALSE
ccadccccabbcbaaa	FALSE
ccddcbcdcabacbcd	FALSE
ccddccdaabacbdab	FALSE
cdcccbdbaaaddabd	FALSE
cdcccccbbcabadab	FALSE
dabacaddadddcbbd	FALSE
dabaccbadcbbdabb	FALSE
dadbaccbcaabaaad	FALSE
dadbadabdacdbbca	FALSE
dbcbaadcccbdcbca	FALSE
dbcbabbcbdbccbca	FALSE
dcacbabaaabdcbbc	FALSE
dcacbabcadccdcaa	FALSE
dcdadcabaadcaaac	FALSE
dcdadcbcbbccbadc	FALSE
ddbbddabbddbadba	FALSE
ddbcaadbbbacddad	FALSE
aaaaaaaabcccdaccb	TRUE
aaaaaabcbcddccbcb	TRUE
aabcdccdbccccadad	TRUE
aabcdcddccaadaccd	TRUE
aadcbcbcdcdcdbcbc	TRUE
aadcbccdbcdbcccbc	TRUE
acbcbccccaabcdacc	TRUE
acbcbccccccbcdcac	TRUE
acdbcdbccbcccbcda	TRUE
acdbcdbccdcdbcbcb	TRUE
adbcbccddadbcbcac	TRUE
adbcbcdacbccbcbcd	TRUE
addacbcacddaccaad	TRUE
addacbccccbccadac	TRUE
bcacacaadbcddaddd	TRUE
bcacacbcdaaddacca	TRUE
bcaddcacbcdddccbc	TRUE
bcaddccadbccbcaad	TRUE
bcbccadcbcaacbcca	TRUE
bcbccaddcccdbcbcd	TRUE
bccbcaacccdaacdbc	TRUE
bccbcacacddbccaaa	TRUE
bccddcacdbcddaaad	TRUE
bccddcadbccbcacdd	TRUE
bcdccbcbcadddbcdb	TRUE
bcdccbcbccacccdda	TRUE
caadadaacadcdcdaa	TRUE
caadbcaddacbcacda	TRUE
cadccbcbcbcaacdcb	TRUE
cadccbccdadaaaabc	TRUE
cbccbcacbcdbccdda	TRUE
cbccbcadaddbcbccd	TRUE
ccbcaaaaccdaccaca	TRUE
ccbcaabcadaabcdad	TRUE
ccddbcbcddcbcbcdc	TRUE
ccddbcdacbcbcddcb	TRUE
cdccccaabccacdcac	TRUE
cdccccadacbcadcaa	TRUE
daadaaccbcacdcccc	TRUE
daadaadccbcacccbc	TRUE
dadcdacddcdcbcadd	TRUE
dadcdbcacddbcadad	TRUE
dbccaaacccadbcbcc	TRUE
dbccaaadacbcacacd	TRUE
dcadaadcbcbcbcddd	TRUE
dcadacaadcccacaad	TRUE
dcdadcbcddbcdcdbc	TRUE
dcdadddaadddadbcb	TRUE
ddbccdccddcccdbcb	TRUE
ddbccddacccaaaccb	TRUE
aaaaaccddcdaccbdc	FALSE
aaaaacdcaaadadcbb	FALSE
aacdbbdbbdccaccab	FALSE
aacdbdabacbbddadb	FALSE
abbadadcbbdbdaadb	FALSE
abbaddadcadbddbcc	FALSE
abddbddccddbabdda	FALSE
abddcbdccbcaddbab	FALSE
accbdaaddbdaddaaa	FALSE
accbdacbdababcadd	FALSE
adbaacbadcbccacba	FALSE
adbaadccbacaacadb	FALSE
adddaaabaacbccbcd	FALSE
adddaaabbcbcbdbdc	FALSE
bacaddcaabcabcddb	FALSE
bacbaacdaaadbcccd	FALSE
bbacaccbabdbcbcca	FALSE
bbacadaacadbdadcc	FALSE
bbcddabdaadcdbcab	FALSE
bbcddbbdadbbcdacc	FALSE
bcbbcccaddcdacadc	FALSE
bcbbccdcabdadaccd	FALSE
bdabababadbbccadd	FALSE
bdababcddccbabdaa	FALSE
bdcccdccbdbcddbda	FALSE
bdcccddbdbacbbdcd	FALSE
cabacbccdbabbaadb	FALSE
cabacbdccdbaabcab	FALSE
cadcdcddacccadbaa	FALSE
cadcddcdbabccaada	FALSE
cbcabbadcdbbcaddd	FALSE
cbcabcaaadaabbcca	FALSE
ccaccdcbbbaccbbda	FALSE
ccacdaaaacacbdacc	FALSE
ccdaadabdabbaabab	FALSE
ccdabbadccadacdbc	FALSE
cdbbdbddbbdaabbbd	FALSE
cdbbdcccadcdabbcc	FALSE
cdddadcadaabbdbbc	FALSE
cdddbaabacbaacbbb	FALSE
daccbddcdacccddcb	FALSE
dacccabaddacbabdc	FALSE
dbbbabcbbddbdbdbc	FALSE
dbbbabdccccacbdab	FALSE
dbddbcbdaaabacbbd	FALSE
dbddbddabdcbbcddc	FALSE
dccbcaccdddbcccab	FALSE
dccbcbaabadbbaadb	FALSE
ddaddcbbbbccdaadb	FALSE
ddaddcbdddddcccdd	FALSE
aaaaaaaaacdbccaaca	TRUE
aaaaaaaacbcccacddc	TRUE
aacaaaacaacdddaccd	TRUE
aacaaacbcacdddacbc	TRUE
acaacadbcadbcbcbca	TRUE
acaacbcbcadadccdbc	TRUE
accadaabcccdacbcad	TRUE
accadaadccbcaddccc	TRUE
adaacaccaddadacbcd	TRUE
adaacaddcadadbcadb	TRUE
adbcddbcbcbcdddacc	TRUE
adbcdddbcbcdccacbc	TRUE
adddbcaddcdadaacbc	TRUE
adddbcbcaacbcacbcc	TRUE
bcaccccbcdbcdcdbca	TRUE
bcaccccdbccacacbcb	TRUE
bcbcadaddbccbccddc	TRUE
bcbcadaddcbcacadad	TRUE
bcbcdbcccddacccccc	TRUE
bcbcdbccdaadddccbc	TRUE
bccbcccccdbcdbccaa	TRUE
bccbccdbcdbcacccbc	TRUE
bcdaadacbcdcadddcb	TRUE
bcdaadaddbcacadbca	TRUE
bcdcdcdbcbcbcdaddb	TRUE
bcdcdcdcccbcdacaaa	TRUE
cacaabcaabcaaaaccd	TRUE
cacaabcbcdcdadcdca	TRUE
cbcaaaccbccbcdadcb	TRUE
cbcaaadcadcdbcbccc	TRUE
cbccbcadaadacbcaca	TRUE
cbccbcadaddaacdcca	TRUE
ccadacbcbcaaaaadda	TRUE
ccadadadadbcbccdda	TRUE
ccdbcbcbcccbcddaad	TRUE
ccdbccacccbcdddbca	TRUE
cdbcdddcadcbcaabca	TRUE
cdcaaadadaabccaaca	TRUE
daaaddbcdcbccdbcac	TRUE
daaadddbccacdbcbcc	TRUE
dadbcaaaacbcbcdadd	TRUE
dadbcaabcdccadbcaa	TRUE
dbcbccbcacdadcaadd	TRUE
dbcbccbcadbcbcdbcc	TRUE
dcacacbcdacadbcbcd	TRUE
dcacacdbcadbcddcbc	TRUE
dcdaccdcbccadccdbc	TRUE
dcdaccddcaabcbcbcc	TRUE
ddbcbccbcadbccbcdc	TRUE
ddbcbccbcdccddbcad	TRUE
aaaaaabbcdacbcddba	FALSE
aaaaabdbcbbbbdccdd	FALSE
aacccbacdbdaacbbad	FALSE
aacccbaddbcbdcacba	FALSE
abbbcadbbccdbcbacb	FALSE
abbbccabccaabbddbd	FALSE
acababaaabaddcabda	FALSE
acababdcdcdababddb	FALSE
acdaaabdcccbccdcaa	FALSE
acdaacbdcdaabccacb	FALSE
adbbaacdccbbbcdacc	FALSE
adbbacaddcdbdcadad	FALSE
adddacbdbbbbabaddb	FALSE
adddbaadaaacbbbabd	FALSE
bacabbdcbcdbdaccab	FALSE
bacabcacaadbbdbadc	FALSE
bbabddbbbbddcbcaaa	FALSE
bbacaacdbabaacacbc	FALSE
bbdaaadbcdccabbccd	FALSE
bbdaadcbccaddddddd	FALSE
bcbddcbddcdddaabdb	FALSE
bcbddcdbcdbddabcbd	FALSE
bdabdbabaaaddbacbb	FALSE
bdabdbbdabdabaccad	FALSE
bdcddcdbabdbccaadd	FALSE
bdcddcdbddbbdbadbc	FALSE
cabbabaddcdbabbdbd	FALSE
cabbaccadcbddabcbb	FALSE
cbaaaaccdbababaacd	FALSE
cbaaababbcbcccaaad	FALSE
cbccaadbbcaacccacc	FALSE
cbccaaddadabcdcbac	FALSE
ccacddbbcddbcadaad	FALSE
ccadaaabdbacddadbd	FALSE
ccdbbacacaadaddddb	FALSE
ccdbbbabadbdbacccb	FALSE
cdbddcbbaccbbaabca	FALSE
cdcaaacacaabccaaba	FALSE
daabbcbbddcacdccac	FALSE
daabbcbcbdccddbccd	FALSE
dacdddacdabccababd	FALSE
dadaaaccccbadadabc	FALSE
dbbdadacccaadadcdd	FALSE
dbbdadadbadcacbaba	FALSE
dcabbcacbdccdbbbca	FALSE
dcabcbabbcccdbcabb	FALSE
dcdacbbcadccdbbbad	FALSE
dcdacbdabbbacddbac	FALSE
ddbbbdadcccabdbacd	FALSE
ddbbbddbbbcddaddac	FALSE
aaaaaabcadbcccbcacb	TRUE
aaaaaadbcacbcddaabc	TRUE
aabcdcaabcdaddbcddd	TRUE
aabcdcacadaccdcbcca	TRUE
aaddaddadacccdccadb	TRUE
aaddbcadccacddadbcd	TRUE
acbcdbcdaadaaddadbc	TRUE
acbcdbcdbcbcbcbcbcd	TRUE
acddccacbccbcbcbcbc	TRUE
acddcccccacadcccdaa	TRUE
adbcdcaacaaccdcaddd	TRUE
adbcdcaadcbcddddbca	TRUE
adddbcadcacbcddaabc	TRUE
adddbcbccbcbcccdddd	TRUE
bcacddacdccbcdbcadd	TRUE
bcacddbcbccadbcaccc	TRUE
bcbcbccbcbccdcdaaad	TRUE
bcbcbccbccdbcaacbcc	TRUE
bcbcddcccddbcdbcbca	TRUE
bcbcddcdaacadaacacb	TRUE
bcccdccaccbcacdadbc	TRUE
bcccdccccacbcbcdbca	TRUE
bcdbcacdcccdcddddda	TRUE
bcdbcacddaddaccdadb	TRUE
bcddcdbcbcccbcdaaca	TRUE
bcddcddaadddaddddbc	TRUE
cacdacdcdcdbcccbcda	TRUE
cacdadbcddbccdbcaaa	TRUE
cbcacdaabcbcbcbcaad	TRUE
cbcacdacaaadadadcca	TRUE
cbcdbcdaacdbccbcbcd	TRUE
cbcdbcdcaabccdacaca	TRUE
ccbccdbcdbccbcdbcca	TRUE
ccbcdaaacbcbcadadcb	TRUE
cdaaaaacadcdbcbccca	TRUE
cdaaacaacaacaaacdcd	TRUE
cdccaabcaddadbcaabc	TRUE
cdccaacdddbcdbcbcbc	TRUE
daacccbcaaddacdbccb	TRUE
daacdaacaaacdcdbcdc	TRUE
dadbccdbcccaabcaacd	TRUE
dadbccdcbccaadccdcb	TRUE
dbcbcdacdbcbccacccc	TRUE
dbcbcdadbcccaabcdaa	TRUE
dcaccaddbcacbcdddad	TRUE
dcaccbcbcaadcaadddd	TRUE
dccddaaadacbcaaccac	TRUE
dccddadcadbcacadbca	TRUE
ddbcbccdadbcdcdbccd	TRUE
ddbcbcdbcbcaacaddbc	TRUE
aaaaaaadacbabaacbba	FALSE
aaaaaaddddaaabadbab	FALSE
aaccdacddcdabddaacb	FALSE
aaccdaddcbaaccaacad	FALSE
abadddbcddadacbddba	FALSE
abadddcdacccdcdbddc	FALSE
abdcaabaaaaadbbbddb	FALSE
abdcaadcbbcdabdcbcb	FALSE
accbbbbcababccbcbaa	FALSE
accbbbbdacbadadcbbb	FALSE
adadadbdaacddbcabcc	FALSE
adadbabcaaababbdbdd	FALSE
addcdaaadacbaabbcca	FALSE
addcdaccccacbbbdbcd	FALSE
bacbaabdbacabcbbbdd	FALSE
bacbaabddbaacbbcacc	FALSE
bbadcdbacbdbccacdda	FALSE
bbaddbadbdcdcacabdd	FALSE
bbdbbadbacbbddabcbb	FALSE
bbdbcabcbbddbdddccd	FALSE
bcbdbbddbadaabbbaaa	FALSE
bcbddbabddaaadbbbbd	FALSE
bdabbbbcaaaabccddcd	FALSE
bdabbbcacacdbdbcbab	FALSE
bdcdabbabcdbdccbcbd	FALSE
bdcdaccaccddbcbdaad	FALSE
cabbdababdbcaaacdac	FALSE
cabbdabbbabbbdbcddb	FALSE
cbaabbbbcdcbabdadbb	FALSE
cbaabbdddaabdbacdda	FALSE
cbcdaacaacdddbdacbb	FALSE
cbcdaacdccbbbdabddd	FALSE
ccbaddcdddadaaddabd	FALSE
ccbbaaabdcabbcacbbd	FALSE
ccddbabdbdbbdccbddd	FALSE
ccddbbddaabcdbdaaad	FALSE
cdcaccacbdcbdbddadd	FALSE
cdcacdaccbddbaddadb	FALSE
daabddcabbbddabdbca	FALSE
daabddccdcdcdccdcbb	FALSE
dadacadacbbcddabbaa	FALSE
dadacdacccdddddadba	FALSE
dbbdbddacaacdabacba	FALSE
dbbdcabaadbadaddabb	FALSE
dcabbacbdacabddabbb	FALSE
dcabbbcabdbcccccacc	FALSE
dccdabacadcaddcbdab	FALSE
dccdabdddbabddaddad	FALSE
ddbbabadcbccdbbbaca	FALSE
ddbbacaacaaabdbcdcd	FALSE
