aaaaaaadac	TRUE
aaaaaacdca	TRUE
aacaddcaad	TRUE
aacaddcdca	TRUE
aaddcaacda	TRUE
aaddcaadad	TRUE
accadaccdd	TRUE
accadadadd	TRUE
acddcadaad	TRUE
acddcadaca	TRUE
adcacaacac	TRUE
adcacadaad	TRUE
adddacdddc	TRUE
adddadaaad	TRUE
bccccccccc	TRUE
bccccccccc	TRUE
bccccccccc	TRUE
bccccccccc	TRUE
bccccccccc	TRUE
bccccccccc	TRUE
bccccccccc	TRUE
bccccccccc	TRUE
bccccccccc	TRUE
bccccccccc	TRUE
bccccccccc	TRUE
bccccccccc	TRUE
caaddddcaa	TRUE
cacaaaaccd	TRUE
cbcccccccc	TRUE
cbcccccccc	TRUE
cbcccccccc	TRUE
cbcccccccc	TRUE
ccbccccccc	TRUE
ccbccccccc	TRUE
ccdcdddaad	TRUE
ccddaacadd	TRUE
cdcbcccccc	TRUE
cdcbcccccc	TRUE
daadadaddc	TRUE
daadcaaaad	TRUE
dadcdccdaa	TRUE
dadcdccdda	TRUE
dbcccccccc	TRUE
dbcccccccc	TRUE
dcaccaddca	TRUE
dcacccacaa	TRUE
dccddbcccc	TRUE
dccddcacda	TRUE
ddbccccccc	TRUE
ddbccccccc	TRUE
aaaaabbccc	FALSE
aaaaacdaab	FALSE
aaccaaacdb	FALSE
aaccabaacb	FALSE
abaddbcdca	FALSE
abaddcacdd	FALSE
abdcbbabaa	FALSE
abdcbbabbb	FALSE
accbdacada	FALSE
accbddcbba	FALSE
adadbadcba	FALSE
adadbbbbab	FALSE
addbcdaacd	FALSE
addbcdadcb	FALSE
bacaadddbc	FALSE
bacabbcdcd	FALSE
bbaccacaab	FALSE
bbaccbbaab	FALSE
bbcdbdcbbc	FALSE
bbcdcaaaba	FALSE
bcbbcaadab	FALSE
bcbbcabcbd	FALSE
bcddbcbccb	FALSE
bcddbdddca	FALSE
bdccabcbdb	FALSE
bdccabdada	FALSE
cabbbacbac	FALSE
cabbbcadcc	FALSE
cbaabbbcad	FALSE
cbaabbcbab	FALSE
cbcccbaccb	FALSE
cbcccddbcc	FALSE
ccbacabdab	FALSE
ccbaccacda	FALSE
ccdcdddabd	FALSE
ccddaabadd	FALSE
cdcbccdbca	FALSE
cdcbcdbdca	FALSE
dabaacaccc	FALSE
dabaacdcdb	FALSE
dadcbcccbd	FALSE
dadcbccddb	FALSE
dbcabbbada	FALSE
dbcabbbbba	FALSE
dcabccaadb	FALSE
dcabcdbccc	FALSE
dccddbcdda	FALSE
dccddcabdb	FALSE
ddbcabbdbc	FALSE
ddbcacbabb	FALSE
aaaaaaadacc	TRUE
aaaaaacadad	TRUE
aacaddddccd	TRUE
aaccaaaacad	TRUE
aaddccaadac	TRUE
aaddccacaca	TRUE
acccaacadac	TRUE
acccaacdaac	TRUE
acddcadccac	TRUE
acddcadcdcc	TRUE
adcaddcdcca	TRUE
adcadddccdc	TRUE
adddaddacaa	TRUE
adddaddcdda	TRUE
bcccccccccc	TRUE
bcccccccccc	TRUE
bcccccccccc	TRUE
bcccccccccc	TRUE
bcccccccccc	TRUE
bcccccccccc	TRUE
bcccccccccc	TRUE
bcccccccccc	TRUE
bcccccccccc	TRUE
bcccccccccc	TRUE
bcccccccccc	TRUE
bcccccccccc	TRUE
caadccddcaa	TRUE
caadcdccaad	TRUE
caddadcaada	TRUE
caddadccdaa	TRUE
cbccccccccc	TRUE
cbccccccccc	TRUE
ccacddcdaca	TRUE
ccacddcdccc	TRUE
ccdccdccaac	TRUE
ccdccddcdcb	TRUE
cdcadaadaca	TRUE
cdcadacadcc	TRUE
daadaadcacc	TRUE
daadaccaaca	TRUE
dadcdacacad	TRUE
dadcdacadcc	TRUE
dbccccccccc	TRUE
dbccccccccc	TRUE
dcadaaacccc	TRUE
dcadaaacddd	TRUE
dccddcdcbcc	TRUE
dccdddaccdc	TRUE
ddbcccccccc	TRUE
ddbcccccccc	TRUE
aaaaabbcccc	FALSE
aaaaacccaab	FALSE
aaccaddabbd	FALSE
aaccbaccbbc	FALSE
abbabbbdbbd	FALSE
abbabdcdddd	FALSE
abdccbbdddd	FALSE
abdcdaaaccb	FALSE
accaddcadbb	FALSE
accaddccadb	FALSE
adbaadaddab	FALSE
adbaadccbad	FALSE
addbddcbcbc	FALSE
addbdddbacb	FALSE
bacadccdcca	FALSE
bacbabbddcc	FALSE
bbadabaadbc	FALSE
bbadabbadcd	FALSE
bbdacdcdcdd	FALSE
bbdadcbabcd	FALSE
bcbdaaaacca	FALSE
bcbdaabcbbb	FALSE
bdabdacadac	FALSE
bdabdbadbbb	FALSE
bdcdacaacbd	FALSE
bdcdacdcdbb	FALSE
cabacdaaaab	FALSE
cabacdbbabb	FALSE
cadcbcbabac	FALSE
cadcbcbdcdc	FALSE
cbcabccccbc	FALSE
cbcabdaaccc	FALSE
ccaccbcabaa	FALSE
ccacccabadd	FALSE
ccdccdccabb	FALSE
ccdccddcdbb	FALSE
cdcadadcbba	FALSE
cdcadbaacbd	FALSE
daadbcdbdad	FALSE
daadbdaaaad	FALSE
dadbbababca	FALSE
dadbbdcddaa	FALSE
dbbdbcabcdb	FALSE
dbbdbddabba	FALSE
dcaccddbbac	FALSE
dcacdabaaca	FALSE
dccddcdcbac	FALSE
dccdddacbcc	FALSE
ddbbcbcbadb	FALSE
ddbbdbbaaba	FALSE
aaaaaaacddad	TRUE
aaaaaacccacd	TRUE
aaccaacdacdc	TRUE
aaccaadacacd	TRUE
aaddccacacdd	TRUE
aaddcccacadc	TRUE
accaddacddda	TRUE
accaddadacdc	TRUE
acdcdaaccccc	TRUE
acdcdaacdcdd	TRUE
adcaacacddcc	TRUE
adcaacadcacc	TRUE
addccdcdaaaa	TRUE
addcdaaacaca	TRUE
bccccccccccc	TRUE
bccccccccccc	TRUE
bccccccccccc	TRUE
bccccccccccc	TRUE
bccccccccccc	TRUE
bccccccccccc	TRUE
bccccccccccc	TRUE
bccccccccccc	TRUE
bccccccccccc	TRUE
bccccccccccc	TRUE
bccccccccccc	TRUE
bccccccccccc	TRUE
cacdaccacadd	TRUE
cacdaccadcdc	TRUE
cbcccccccccc	TRUE
cbcccccccccc	TRUE
cbcccccccccc	TRUE
cbcccccccccc	TRUE
cccbcccccccc	TRUE
cccbcccccccc	TRUE
cdadccaccaaa	TRUE
cdadccadcdda	TRUE
cddacdacddac	TRUE
cddacdccccca	TRUE
dacaadaccdcc	TRUE
dacaaddacadd	TRUE
dbcccccccccc	TRUE
dbcccccccccc	TRUE
dbcccccccccc	TRUE
dbcccccccccc	TRUE
dcaddacdcddd	TRUE
dcaddcaaadad	TRUE
dcdbcccccccc	TRUE
dcdbcccccccc	TRUE
ddbccccccccc	TRUE
ddbccccccccc	TRUE
aaaaabbaabbb	FALSE
aaaaabcdcdca	FALSE
aacacddadabd	FALSE
aacacdddcbca	FALSE
abaddaaabbad	FALSE
abaddbcccbbd	FALSE
abdcababaacd	FALSE
abdcababaada	FALSE
acbdccccadba	FALSE
acbdcdbaaccc	FALSE
adabdaadadcb	FALSE
adabdbabaada	FALSE
addabcbaaaba	FALSE
addacbcaadda	FALSE
bacabdaccbda	FALSE
bacabdadacdb	FALSE
bbaccccadccb	FALSE
bbacdaacbcab	FALSE
bbdbaaabadac	FALSE
bbdbaacaadda	FALSE
bcbdbbbdabda	FALSE
bcbdbcacaadd	FALSE
bdacbacadabc	FALSE
bdacbacbabac	FALSE
bddcabbacdca	FALSE
bddcbacaaacd	FALSE
cacbbcdddbdd	FALSE
cacbcaaadbbb	FALSE
cbbabdbbacda	FALSE
cbbacaaadcbd	FALSE
cbddadabdaac	FALSE
cbddadbddddb	FALSE
cccbbcdddacd	FALSE
cccbbddbcacc	FALSE
cdadaabcaabb	FALSE
cdadabababcb	FALSE
cddabdddabdd	FALSE
cddacabcdcac	FALSE
dabcbccacbba	FALSE
dabcbcdcbddb	FALSE
dbaabacbaadb	FALSE
dbaabadbbddc	FALSE
dbccadbcbbdd	FALSE
dbccbabbbbda	FALSE
dcadcdabdcdd	FALSE
dcadcdcdabaa	FALSE
dcdbaacdaccd	FALSE
dcdbaaddcbad	FALSE
ddbccbabdcac	FALSE
ddbcccccdcac	FALSE
aaaaaaadaddca	TRUE
aaaaaadadddac	TRUE
aaccacadaddad	TRUE
aaccacddcaada	TRUE
aaddcacddaada	TRUE
aaddcadadcacd	TRUE
accacadaacccc	TRUE
accacadccaddd	TRUE
acdcadcccadca	TRUE
acdccacaaadad	TRUE
adadcdacaaadc	TRUE
adadcdaccacac	TRUE
addccadaadccc	TRUE
addcccacadadd	TRUE
bcccccccccccc	TRUE
bcccccccccccc	TRUE
bcccccccccccc	TRUE
bcccccccccccc	TRUE
bcccccccccccc	TRUE
bcccccccccccc	TRUE
bcccccccccccc	TRUE
bcccccccccccc	TRUE
bcccccccccccc	TRUE
bcccccccccccc	TRUE
bcccccccccccc	TRUE
bcccccccccccc	TRUE
caacadcacccac	TRUE
caacadccacdca	TRUE
cadccaacdcccd	TRUE
cadccaadadada	TRUE
cbccccccccccc	TRUE
cbccccccccccc	TRUE
cbccccccccccc	TRUE
cbccccccccccc	TRUE
cccbccccccccc	TRUE
cccbccccccccc	TRUE
cdbcccccccccc	TRUE
cdbcccccccccc	TRUE
cdddadcdadada	TRUE
cdddadcdcccdc	TRUE
dacddaadcadda	TRUE
dacddacaaaddd	TRUE
dbccccccccccc	TRUE
dbccccccccccc	TRUE
dcaaccdcddadd	TRUE
dcaacdacacddc	TRUE
dccdbcccccccc	TRUE
dccdbcccccccc	TRUE
ddbcccccccccc	TRUE
ddbcccccccccc	TRUE
aaaaaaabbabda	FALSE
aaaaabcbbcdac	FALSE
aaccaabcacbda	FALSE
aaccabaabacbc	FALSE
abbabdcccdbaa	FALSE
abbacbbbdcaac	FALSE
abdcacadcccac	FALSE
abdcadadaaccb	FALSE
acbdbaaddccab	FALSE
acbdbababbcba	FALSE
adabacbbbacdc	FALSE
adabacdadacda	FALSE
adcdaccdacbdb	FALSE
adcdadacbddca	FALSE
babccdabcadbd	FALSE
babcdaccdbddd	FALSE
bbaadcacccbac	FALSE
bbabaaddabdcd	FALSE
bbccdaadabaad	FALSE
bbccddccdcccb	FALSE
bcbbabcaccacb	FALSE
bcbbabcadbabd	FALSE
bcddbadccadda	FALSE
bcddbbdcddbad	FALSE
bdcabccdbbbdc	FALSE
bdcabcdddcdaa	FALSE
caaccacabbdab	FALSE
caaccacdababc	FALSE
cadabccbaaabb	FALSE
cadacbdaacaaa	FALSE
cbbccdabbbddb	FALSE
cbbccdcbbcdba	FALSE
cbddccdbbbbca	FALSE
cbddcdbbcbbbb	FALSE
cccbdbabdcbbc	FALSE
cccbdbacddcbb	FALSE
cdbabdabdaddc	FALSE
cdbacaacbadad	FALSE
cdddadbccbada	FALSE
cdddaddcabbdc	FALSE
dacccbacdaccb	FALSE
daccccbaddddc	FALSE
dbbbdccdbadbb	FALSE
dbbbddcdaacda	FALSE
dcaacbbcbccdc	FALSE
dcaacccbcadbb	FALSE
dccdbcadcdacc	FALSE
dccdbccbbcaba	FALSE
ddbccbbbdacaa	FALSE
ddbccbccaaddc	FALSE
aaaaaaadaddcad	TRUE
aaaaaadaddacaa	TRUE
aacadcdaaacadc	TRUE
aacadcddaadccc	TRUE
aaddcaccadaadc	TRUE
aaddcadccdadca	TRUE
acccaaadddddcd	TRUE
acccaacaaaadaa	TRUE
acdccdaccaddda	TRUE
acdccdaddcdcca	TRUE
adaddaaadccccc	TRUE
adaddacccdaddc	TRUE
addccacccadaac	TRUE
addccacdaddadd	TRUE
bccccccccccccc	TRUE
bccccccccccccc	TRUE
bccccccccccccc	TRUE
bccccccccccccc	TRUE
bccccccccccccc	TRUE
bccccccccccccc	TRUE
bccccccccccccc	TRUE
bccccccccccccc	TRUE
bccccccccccccc	TRUE
bccccccccccccc	TRUE
bccccccccccccc	TRUE
bccccccccccccc	TRUE
caacacddaaaacd	TRUE
caacacddaaccaa	TRUE
cadadaddccdadc	TRUE
cadadccddcdcaa	TRUE
cbcccccccccccc	TRUE
cbcccccccccccc	TRUE
ccaadaaccddddd	TRUE
ccaadaaddaddcd	TRUE
cccdbccccccccc	TRUE
cccdcbcccccccc	TRUE
cdbccccccccccc	TRUE
cdbccccccccccc	TRUE
cdddaddadadddd	TRUE
cdddbccccccccc	TRUE
dacddcaaddaaac	TRUE
dacddcaddaacda	TRUE
dbcccccccccccc	TRUE
dbcccccccccccc	TRUE
dbcccccccccccc	TRUE
dbcccccccccccc	TRUE
dccbcccccccccc	TRUE
dccbcccccccccc	TRUE
ddbccccccccccc	TRUE
ddbccccccccccc	TRUE
aaaaaadadbcada	FALSE
aaaaacaddadbbd	FALSE
aaccbddbacccbb	FALSE
aacccaadaacbca	FALSE
abadadaddaccda	FALSE
abadadbaacdbac	FALSE
abdadabacbbbbc	FALSE
abdadbabaababc	FALSE
acbddbcdadccca	FALSE
acbddcdcdbbdba	FALSE
adacbdcbccdccc	FALSE
adaccaacbadbdb	FALSE
addbdddaccdcdb	FALSE
addcaaaadaaabb	FALSE
babdcabaaddaac	FALSE
babdcbbcaabbca	FALSE
bbaccadccabdac	FALSE
bbaccbbbccaacb	FALSE
bbcddbaadabcad	FALSE
bbcddbcbdaaaab	FALSE
bcbbcdccabdbdc	FALSE
bcbbdadcadabda	FALSE
bcddbabdcadadd	FALSE
bcddbabdddadbb	FALSE
bdcccacacadadc	FALSE
bdcccbdbbaddba	FALSE
cabbacdcaacdbc	FALSE
cabbadbddaacdb	FALSE
caddabdccdcaaa	FALSE
caddacbcbdcddc	FALSE
cbcbbcadbccbba	FALSE
cbcbbcbddadddb	FALSE
ccacdcddbdbccc	FALSE
ccacddabcbacbd	FALSE
ccdbadabbbddca	FALSE
ccdbaddacdcbdc	FALSE
cdcabcdbbcccdd	FALSE
cdcacaaaaabcdb	FALSE
daacbdcadbadcb	FALSE
daaccadccbdcdb	FALSE
dadbcbbbdaabdb	FALSE
dadbccbdbbbdab	FALSE
dbbdbbcdcbbabb	FALSE
dbbdbddadccdac	FALSE
dcacccacbbddba	FALSE
dcacccbbacbcba	FALSE
dcdaadadbdbdab	FALSE
dcdabaccaadacc	FALSE
ddbbcdaaadcdba	FALSE
ddbbdaadccbcdd	FALSE
aaaaaaaacaaaaaa	TRUE
aaaaaaacacacdaa	TRUE
aaccacacadddada	TRUE
aaccaccddcdcdca	TRUE
aaddacaaccaaadc	TRUE
aaddacaaccaccaa	TRUE
accaacccacddaad	TRUE
accaaccdcddddca	TRUE
acdcdadddcdadaa	TRUE
acdcdcaadacdadc	TRUE
adcacadcdddcdad	TRUE
adcacaddaccadca	TRUE
adddaacacacdccc	TRUE
adddaacacdacdca	TRUE
bcccccccccccccc	TRUE
bcccccccccccccc	TRUE
bcccccccccccccc	TRUE
bcccccccccccccc	TRUE
bcccccccccccccc	TRUE
bcccccccccccccc	TRUE
bcccccccccccccc	TRUE
bcccccccccccccc	TRUE
bcccccccccccccc	TRUE
bcccccccccccccc	TRUE
bcccccccccccccc	TRUE
bcccccccccccccc	TRUE
cacacacacaacdda	TRUE
cacacaccadaddcd	TRUE
cbccccccccccccc	TRUE
cbccccccccccccc	TRUE
cbccccccccccccc	TRUE
cbccccccccccccc	TRUE
ccbcccccccccccc	TRUE
ccbcccccccccccc	TRUE
ccddcdaccddaaac	TRUE
ccdddaccaadcdda	TRUE
cdcbccccccccccc	TRUE
cdcbccccccccccc	TRUE
daaccadcaddcaca	TRUE
daaccaddcddcdda	TRUE
dadadcdaddadcda	TRUE
dadadcdcccacaca	TRUE
dbccccccccccccc	TRUE
dbccccccccccccc	TRUE
dcaaaaccccccddd	TRUE
dcaaaadadcdaaca	TRUE
dcccadccccccaaa	TRUE
dcccbcccccccccc	TRUE
ddbcccccccccccc	TRUE
ddbcccccccccccc	TRUE
aaaaaaaacabbadc	FALSE
aaaaadaabdbadaa	FALSE
aaccbbabcbddbda	FALSE
aaccbbacbddbccb	FALSE
abbadabccddacdc	FALSE
abbadacdbddcdba	FALSE
abdbbdbbddcacaa	FALSE
abdbbdcbcabaaad	FALSE
acbcccbdbbcbdba	FALSE
acbccdaccddcdda	FALSE
adabaadccaaadbd	FALSE
adabadadabcaccb	FALSE
adcbddbdddadada	FALSE
adccaacbadbdabc	FALSE
baaddabdbcccbcb	FALSE
baaddacbadcacbd	FALSE
badcdaabadcdcba	FALSE
badcdabddabadbd	FALSE
bbcbcabbadccbab	FALSE
bbcbcacbbbbacdd	FALSE
bcadaacacbdaaac	FALSE
bcadabdabdacdcd	FALSE
bcdcdbcbadbccdc	FALSE
bcdcdcaccdcdcda	FALSE
bdcbbabcacbacca	FALSE
bdcbbcacbbacabc	FALSE
caadccbaaddccdc	FALSE
caadccdccddadbd	FALSE
cadbbdcbadcabbb	FALSE
cadbbdccabadddd	FALSE
cbbdacdcccccabd	FALSE
cbbdadbbbcaabca	FALSE
ccacccdbdacdacd	FALSE
ccacdaabdbbbdcc	FALSE
ccdacbadddbadbc	FALSE
ccdacbbdbcbdaac	FALSE
cdbcddddbacbcad	FALSE
cdbdaabbbbdbbda	FALSE
daabbcacbbcdaba	FALSE
daabbdaabcdbbac	FALSE
dacdccacabdcbba	FALSE
dacdcccaacaacab	FALSE
dbbdcababccbbbd	FALSE
dbbdcbabcddadda	FALSE
dcacabcabdbbcca	FALSE
dcacabcccdaddcd	FALSE
dccdaccdcbdccba	FALSE
dccdadadaacbcdd	FALSE
ddbbbdcddbbcddc	FALSE
ddbbcabacbabcac	FALSE
aaaaaaaaaacadacd	TRUE
aaaaaaaaaddadaac	TRUE
aaccadddcdddcdaa	TRUE
aacccaaddcdccacc	TRUE
aaddaddddaccacaa	TRUE
aaddcaacadacaddd	TRUE
accadacccdaccadc	TRUE
accadaccdcaadada	TRUE
acdcdcacddaaccdc	TRUE
acdcdcadaaddaaaa	TRUE
adadcddccdaadcad	TRUE
adaddaadccdccaca	TRUE
addadacdaaddacdd	TRUE
addadadaaaccdcdd	TRUE
bccccccccccccccc	TRUE
bccccccccccccccc	TRUE
bccccccccccccccc	TRUE
bccccccccccccccc	TRUE
bccccccccccccccc	TRUE
bccccccccccccccc	TRUE
bccccccccccccccc	TRUE
bccccccccccccccc	TRUE
bccccccccccccccc	TRUE
bccccccccccccccc	TRUE
bccccccccccccccc	TRUE
bccccccccccccccc	TRUE
caacddacccadccaa	TRUE
caacdddcddcaaadc	TRUE
cadccdcaaaccdcac	TRUE
cadccdcddcdadaad	TRUE
cbcccccccccccccc	TRUE
cbcccccccccccccc	TRUE
ccadadacdcadcdca	TRUE
ccadcaacccdccdaa	TRUE
ccdbcccccccccccc	TRUE
ccdbcccccccccccc	TRUE
cdbccccccccccccc	TRUE
cdbccccccccccccc	TRUE
daacaadadcddddac	TRUE
daacaaddccddadaa	TRUE
dadcdadcdadcacdd	TRUE
dadcdcddaccdacca	TRUE
dbcccccccccccccc	TRUE
dbcccccccccccccc	TRUE
dcacccddccdcdacc	TRUE
dcaccdaacaccaada	TRUE
dcdbcccccccccccc	TRUE
dcdbcccccccccccc	TRUE
ddbccccccccccccc	TRUE
ddbccccccccccccc	TRUE
aaaaaabbdcbdcaab	FALSE
aaaaaadbbdbabdcc	FALSE
aaccaacdcadbaccb	FALSE
aaccabcbcaacacbb	FALSE
abbacccabbddddca	FALSE
abbaccddbaccbccb	FALSE
abddacacbdaaddac	FALSE
abddacbacbdddccb	FALSE
accadaddbcdccbab	FALSE
accadbcbcadaabcc	FALSE
adbabbadcaaccadb	FALSE
adbabcbddbdcdaaa	FALSE
adddbcadbcdddbad	FALSE
adddbddaadacbbaa	FALSE
bacccacabadcbbdc	FALSE
bacccbaddbdbabac	FALSE
bbbaccaabdabbbac	FALSE
bbbacdaabaabdacd	FALSE
bbdcaacbabacccba	FALSE
bbdcabbaccaadcdc	FALSE
bccabdcdbbabcbdd	FALSE
bccabdddaccadbcc	FALSE
bdadabcbadccdcda	FALSE
bdadabdbabbaddbb	FALSE
bddbadabcdaddcdc	FALSE
bddbadadccbbcbda	FALSE
cabdadbccbccdbbd	FALSE
cabdaddaabdcacac	FALSE
cbaaabbbabaabdad	FALSE
cbaabaaaacdbddba	FALSE
cbcdbababaabdbad	FALSE
cbcdbabccbcabbba	FALSE
ccbbbddbaadcdaaa	FALSE
ccbbbddbabdaddbb	FALSE
ccdcddaaadcdcbcd	FALSE
ccdcddabbdcbbcdb	FALSE
cdcbbcbbdddccaac	FALSE
cdcbbcbddbbbdcdc	FALSE
daadbbdcacdacdda	FALSE
daadbcacacccbdcd	FALSE
dadccdcabbccdcac	FALSE
dadcdabcccaadbdc	FALSE
dbccbdcdbbabddcb	FALSE
dbcccabcdbbcabba	FALSE
dcbadadbbcbdacbd	FALSE
dcbadadbcacdbaac	FALSE
dcdbcdbabcbadbab	FALSE
dcdbcdbbabdbddcd	FALSE
ddbdabcdadbcaddc	FALSE
ddbdabdaaccaaacc	FALSE
aaaaaaaddaddcaadd	TRUE
aaaaaacaaaccdacdd	TRUE
aaccadcdcdadaccdd	TRUE
aaccadcddddcaaaca	TRUE
aaddadcdcaccaaddd	TRUE
aaddadddaacacccca	TRUE
accccadccacddcaaa	TRUE
acccccaccddcaddad	TRUE
acddddddccdddaadc	TRUE
adaaaaadcacddcdad	TRUE
adccdacdccdacaaac	TRUE
adccdadcaccddaccd	TRUE
adddddadddaacdcac	TRUE
adddddccaccccaadd	TRUE
bcccccccccccccccc	TRUE
bcccccccccccccccc	TRUE
bcccccccccccccccc	TRUE
bcccccccccccccccc	TRUE
bcccccccccccccccc	TRUE
bcccccccccccccccc	TRUE
bcccccccccccccccc	TRUE
bcccccccccccccccc	TRUE
bcccccccccccccccc	TRUE
bcccccccccccccccc	TRUE
bcccccccccccccccc	TRUE
bcccccccccccccccc	TRUE
cacaddccdcaadddad	TRUE
cacadddccacadacdc	TRUE
cbccccccccccccccc	TRUE
cbccccccccccccccc	TRUE
cbccccccccccccccc	TRUE
cbccccccccccccccc	TRUE
ccadddadaddccccdc	TRUE
ccbcccccccccccccc	TRUE
ccdcaccaaddcdacda	TRUE
ccdcacccdcccdaadd	TRUE
cdcaaacdccdccddad	TRUE
cdcaaadacadcacaca	TRUE
daaccdcdacaaaaccd	TRUE
daaccdcdcacccdcac	TRUE
dadcaadcdcdcdaaad	TRUE
dadcacaaacddcacac	TRUE
dbccccccccccccccc	TRUE
dbccccccccccccccc	TRUE
dcacacddaaaadccdc	TRUE
dcacadacdddcdaada	TRUE
dcdaaaaccacacccad	TRUE
dcdaaacaaaccdcccd	TRUE
ddbcccccccccccccc	TRUE
ddbcccccccccccccc	TRUE
aaaaabacbacdbdaca	FALSE
aaaaabccbbdcbccdb	FALSE
aaccbbdcdaacbdcab	FALSE
aaccbcbcaddddbadd	FALSE
abbabddbdccddcbca	FALSE
abbacbdabcaccaaaa	FALSE
abdcccdbababbbdab	FALSE
abdccdaadcddccadb	FALSE
acccabdbacacbddbb	FALSE
acccadacdbccacccb	FALSE
adadadcdbcaaaccda	FALSE
adadadcdcaabbcddb	FALSE
addbcbbbddbbacddc	FALSE
addbcbcccabbacbab	FALSE
bacabbaacdcdbbdcc	FALSE
bacabcadaabcccbad	FALSE
bbaccddadccaacbca	FALSE
bbacdaacdbacbdaad	FALSE
bbdbccbcbccaaabcd	FALSE
bbdbcdbbdcabbbaba	FALSE
bccaadbaaaacbadad	FALSE
bccaadcdadaaacacb	FALSE
bdacbabdccddccbbb	FALSE
bdacbcdbbdbcbdbaa	FALSE
bddadcaaaabdddcad	FALSE
bddadcccaaccdbbbb	FALSE
cabdcbbcabbdcdabb	FALSE
cabddacbddadcabab	FALSE
cbabcdccdccbcccda	FALSE
cbabdabbaccbddadc	FALSE
cbcdadaaabcbacddb	FALSE
cbcdadaabdcbbcacb	FALSE
ccbcbaddadcadbcdd	FALSE
ccbcbbdbdbbabbbca	FALSE
cdaacdcadcaccddcb	FALSE
cdaadbcdadaccaccc	FALSE
cdccddacdaaacbacb	FALSE
cdcdaabcaaccbddcc	FALSE
dabbabaabdadbdadb	FALSE
dabbabacdbbcaccdb	FALSE
daddcabdabadcaaab	FALSE
daddcacbdbcccacaa	FALSE
dbcbdcbcbcdcbaadd	FALSE
dbcbdccbbdbcdabba	FALSE
dcacdcbbbcdcbdbab	FALSE
dcacdccbcddabdbbb	FALSE
dcdacaccbaadddbdc	FALSE
dcdacbbcdacacbadb	FALSE
ddbdbbdacbbacaadc	FALSE
ddbdbcbddbaddaacb	FALSE
aaaaaaadaccccdcada	TRUE
aaaaaaccdcacdccaac	TRUE
aaccccdcccaaaacacd	TRUE
aaccccddadaaaddcad	TRUE
aadddaadddcaccccdd	TRUE
aadddadaddaddaadac	TRUE
acccaddaaacdddaacd	TRUE
acccaddccdcadacadd	TRUE
acdddaaaccaccaadcd	TRUE
acdddaacacadacdacc	TRUE
adcadcccddcacaaccc	TRUE
adcaddacaaccacddda	TRUE
adddaaacadcacdaadc	TRUE
adddaaaccccccddcdd	TRUE
bccccccccccccccccc	TRUE
bccccccccccccccccc	TRUE
bccccccccccccccccc	TRUE
bccccccccccccccccc	TRUE
bccccccccccccccccc	TRUE
bccccccccccccccccc	TRUE
bccccccccccccccccc	TRUE
bccccccccccccccccc	TRUE
bccccccccccccccccc	TRUE
bccccccccccccccccc	TRUE
bccccccccccccccccc	TRUE
bccccccccccccccccc	TRUE
caaddaadcaaddcddca	TRUE
caaddacacacacccdac	TRUE
cadddaacaddaccdccc	TRUE
cadddacdacadcaccca	TRUE
cbcccccccccccccccc	TRUE
cbcccccccccccccccc	TRUE
ccbccccccccccccccc	TRUE
ccbccccccccccccccc	TRUE
ccddccdcbccccccccc	TRUE
ccddcdcdaadadaaacc	TRUE
cdcaacdcacacddcacc	TRUE
cdcacaaadadddadccc	TRUE
daacccadcaacddcadc	TRUE
daaccccddcacaaddca	TRUE
dadadcdddddcddcadc	TRUE
dadaddaccccdaaaaac	TRUE
dbcccccccccccccccc	TRUE
dbcccccccccccccccc	TRUE
dcaadaaadacddadcad	TRUE
dcaadaaddadcadcdcc	TRUE
dccccaccadddcaacdc	TRUE
dccccbcccccccccccc	TRUE
ddbccccccccccccccc	TRUE
ddbccccccccccccccc	TRUE
aaaaaaaacacbbcdbcd	FALSE
aaaaaadadbccdabada	FALSE
aaccdbdcbbbdbcbbbd	FALSE
aaccdbddcacbccabdb	FALSE
abbabacaaaccbdddbc	FALSE
abbabbbddcabbbadaa	FALSE
abdcacacaaacbabdac	FALSE
abdcaccabdcdaacddb	FALSE
accadcbddabdbddcca	FALSE
accaddcabcddddcaac	FALSE
adadababddabbccabb	FALSE
adadabbccbadbcbcca	FALSE
addbababadbbcbabbb	FALSE
addbabbbccabbdbcbc	FALSE
babdddcdbccacbbcba	FALSE
bacaaabddbbcdddbbc	FALSE
bbacabdbccdbabdbda	FALSE
bbacacaaccdcaacbad	FALSE
bbdacaabcbbdabbcab	FALSE
bbdacadcaaddaccccb	FALSE
bcbdababcdbdddbdad	FALSE
bcbdabbaababbdadda	FALSE
bdabbdcdbcccccbacd	FALSE
bdabbddcaccdcbabbc	FALSE
bdccbbdaddccbdccca	FALSE
bdccbdaddabacdbacb	FALSE
cabbaccddddbdcbdab	FALSE
cabbbaadacbdaabdab	FALSE
caddbdddcddbbabcdc	FALSE
caddcaaaccdcacbdab	FALSE
cbcbbdadbdaabdcaba	FALSE
cbcbbddabacdaddbaa	FALSE
ccbacbdddaddaddbac	FALSE
ccbacdbcdccbabbdcc	FALSE
ccddccdcbadddcbdcd	FALSE
ccddcdcdabdadaaabc	FALSE
cdcabbbddcabcdabcd	FALSE
cdcabbcbbabacbbdbd	FALSE
daacadbdcaacbdddba	FALSE
daacbadbbcabcbdcbd	FALSE
dadadbabcdcbaddddb	FALSE
dadbaabdccbaacddcb	FALSE
dbbccdcddadaabddba	FALSE
dbbcdccccadacddadd	FALSE
dcaadaaadbcadcbdca	FALSE
dcaadbabbabaacabcd	FALSE
dccccaccadcdbabccc	FALSE
dccccbbbaadacbacda	FALSE
ddbbbccdbbddbaaabb	FALSE
ddbbcbcbaabadcadbb	FALSE
aaaaaaadaadadadddaa	TRUE
aaaaaacdaacddaaadaa	TRUE
aaccacdadacdddaaacd	TRUE
aaccacddadcadddccac	TRUE
aadddcdcadcccdacdaa	TRUE
aadddcddddcdccacdac	TRUE
acccccaccdacdcacaaa	TRUE
acccccccaaacdadcacc	TRUE
acdddcddccdcadccaca	TRUE
acddddaadadaddacdca	TRUE
adccadaadadcdaadaac	TRUE
adccaddaaaadcaccaac	TRUE
bcccccccccccccccccc	TRUE
bcccccccccccccccccc	TRUE
bcccccccccccccccccc	TRUE
bcccccccccccccccccc	TRUE
bcccccccccccccccccc	TRUE
bcccccccccccccccccc	TRUE
bcccccccccccccccccc	TRUE
bcccccccccccccccccc	TRUE
bcccccccccccccccccc	TRUE
bcccccccccccccccccc	TRUE
bcccccccccccccccccc	TRUE
bcccccccccccccccccc	TRUE
bcccccccccccccccccc	TRUE
bcccccccccccccccccc	TRUE
cacaacaaaaaddcacdaa	TRUE
cacaaccaaddaddaaadd	TRUE
caddddcdaaacaaccdaa	TRUE
caddddcddcacaaaaacc	TRUE
cbccccccccccccccccc	TRUE
cbccccccccccccccccc	TRUE
ccbcccccccccccccccc	TRUE
ccbcccccccccccccccc	TRUE
ccdcaddddcddcdcacac	TRUE
ccdcbcccccccccccccc	TRUE
cdcbccccccccccccccc	TRUE
cdcbccccccccccccccc	TRUE
daacadcccdcdcddcaac	TRUE
daaccaacaddadcaadaa	TRUE
dadadaaacdacdcdaaac	TRUE
dadadcccccccdaacadc	TRUE
dbccccccccccccccccc	TRUE
dbccccccccccccccccc	TRUE
dcaacdcadacdcadcccc	TRUE
dcaadaaccacacaddacc	TRUE
dccdaddaacdcdddacaa	TRUE
dccdaddaccaddcacccc	TRUE
ddbcccccccccccccccc	TRUE
ddbcccccccccccccccc	TRUE
aaaaaadbdcccdccdbdc	FALSE
aaaaabcdcaccadbccdb	FALSE
aaccbcccbadccbbdaab	FALSE
aaccbdaddabcccdcdcb	FALSE
abbcdbdbcdbabcdbbdd	FALSE
abbcdcbabdccddacbab	FALSE
acaacacacaaacdbdcbc	FALSE
acaacbadddacbcbabdb	FALSE
acccacbdcaadadabcab	FALSE
acccadccabaaccacdba	FALSE
adadabaacaabbcbcbbc	FALSE
adadabadacbcadccbda	FALSE
addabacbcaaccbdcdaa	FALSE
addabadbcadbbddcccc	FALSE
babccbdccaaacbadbbc	FALSE
babcccaaddccdddbaaa	FALSE
bbaabbddcadbcdacbca	FALSE
bbaabcadbadadbbabcb	FALSE
bbcdaadbdcbbcccddcc	FALSE
bbcdacbdbaccbcccddb	FALSE
bcbbdbaadcbdaccbbac	FALSE
bcbbdbaadccadacbbba	FALSE
bcddcbbaddddadbadbc	FALSE
bcddccbacaacbcaccbb	FALSE
bdcdabcdbbdcabbdaba	FALSE
bdcdabdbbddcbbcacdc	FALSE
cabbadacdadbbadabcd	FALSE
cabbadddcacbadbaabb	FALSE
caddcddacabcaccbbbd	FALSE
cadddaaadddbcccdaaa	FALSE
cbcbcabcdcbccaaadda	FALSE
cbcbcadacaccbcbaccd	FALSE
ccbaaabbadbcadbcaca	FALSE
ccbaabbbbccabbacadd	FALSE
ccdccbdabbbbcaadcdc	FALSE
ccdccccaaccdcaacadb	FALSE
cdcacbdabccdccadddc	FALSE
cdcacbdabcdbcbbadbd	FALSE
daadcadcadaabdcbbab	FALSE
daadcbbddbaaaddadad	FALSE
dadcbccaddabaddacdd	FALSE
dadcbdbbcaadcaddadd	FALSE
dbbdddcabcdbcdddccc	FALSE
dbbddddcadcacdddbda	FALSE
dcabcbcccdbdaccaddb	FALSE
dcabccacbaaabcadcad	FALSE
dcdaacaccaccabacadc	FALSE
dcdaacaccadddbaaacc	FALSE
ddbbcdbdbdbcbaddddd	FALSE
ddbbdaaabcaaadcdbda	FALSE
