abbbbbccbd	TRUE
abbbbbddbb	TRUE
abcccdcbcb	TRUE
abcccdcbdc	TRUE
abddbcbcbb	TRUE
abddbcbddc	TRUE
accbcdbbcb	TRUE
accbcdbddd	TRUE
acdcdbdbcc	TRUE
acdcdbdcdd	TRUE
adbdccbdcb	TRUE
adbdccbdcd	TRUE
addbcddbcd	TRUE
addbdbbcdc	TRUE
bacbbccdcd	TRUE
bacbbccddb	TRUE
badddcccbc	TRUE
badddccccc	TRUE
bbccacdcbc	TRUE
bbccadbdbb	TRUE
bcbadbbdcd	TRUE
bcbadbdddd	TRUE
bcdccdaccb	TRUE
bcdccddcad	TRUE
bdcacccddc	TRUE
bdcaccdccd	TRUE
cabcdcbddb	TRUE
cabcdccdbd	TRUE
cadbdbdbcd	TRUE
cadbdbdcbc	TRUE
cbbdabbcbc	TRUE
cbbdabbccc	TRUE
ccaccbbddb	TRUE
ccacccdcbb	TRUE
ccdabdbcbc	TRUE
ccdabddcbd	TRUE
cdbccacccb	TRUE
cdbccacdbb	TRUE
dabbcbdbbb	TRUE
dabbcbdccc	TRUE
dadbcbccbc	TRUE
dadbcbcddc	TRUE
dbbcdcabcd	TRUE
dbbcdcacdc	TRUE
dcabccdbbb	TRUE
dcabccdcbb	TRUE
dcccccddac	TRUE
dccccdabdc	TRUE
ddbadcdcbd	TRUE
ddbaddbdcd	TRUE
aaaaaaccdc	FALSE
aaaaaacdda	FALSE
aacbbadbdd	FALSE
aacbbbbbbb	FALSE
abaccbacca	FALSE
abaccbcaba	FALSE
abdbadbaab	FALSE
abdbadcbca	FALSE
accaabcccb	FALSE
accaacaccc	FALSE
adabdcddac	FALSE
adabdddacd	FALSE
addadcaaba	FALSE
addadcabdd	FALSE
babadbdbbc	FALSE
babadcbdcb	FALSE
baddbbddac	FALSE
baddbdaada	FALSE
bbcdacbaac	FALSE
bbcdadbcda	FALSE
bcbbbbddaa	FALSE
bcbbcacdba	FALSE
bcddcaccac	FALSE
bcddcbdcaa	FALSE
bdccacacbd	FALSE
bdccbbbdaa	FALSE
caaddaacca	FALSE
caaddaacdb	FALSE
cadadbaaca	FALSE
cadadbabac	FALSE
cbbddddbaa	FALSE
cbcaaabacb	FALSE
ccacdcbbda	FALSE
ccacddaada	FALSE
ccdabbbdba	FALSE
ccdabbdcad	FALSE
cdbbdbacda	FALSE
cdbbdbbaba	FALSE
daaacdacdc	FALSE
daaacdccbc	FALSE
dacdbaaccb	FALSE
dacdbbcbda	FALSE
dbbbbdbaba	FALSE
dbbbcacbda	FALSE
dcababcada	FALSE
dcabacccda	FALSE
dccdbcbbaa	FALSE
dccdbcdbaa	FALSE
ddbbcddcaa	FALSE
ddbbdbcdaa	FALSE
abbbbbcddcc	TRUE
abbbbbddcdd	TRUE
abccbccddcd	TRUE
abccbdbbbbd	TRUE
abddcdbcddd	TRUE
abddcdbdcbc	TRUE
accbdcdbddc	TRUE
accbdcdcbcc	TRUE
acdcdbbbccc	TRUE
acdcdbcccdb	TRUE
adbddbcdbcc	TRUE
adbddbcdcbd	TRUE
addbddccddb	TRUE
addcbbbcbdb	TRUE
babdccdcbbd	TRUE
babdccddddc	TRUE
baddcdccddb	TRUE
baddcdddccb	TRUE
bbccaddcbcd	TRUE
bbccbadbdcb	TRUE
bcbbabdbdcb	TRUE
bcbbacbbdbd	TRUE
bcdcddbbcad	TRUE
bcdcdddddbb	TRUE
bdcbadcccdb	TRUE
bdcbadcccdd	TRUE
cabdccbdddd	TRUE
cabdcccbdbd	TRUE
caddbbcbbcb	TRUE
caddbcbbbcb	TRUE
cbcbdcaccdd	TRUE
cbcbddabdbc	TRUE
ccbacbbdbbd	TRUE
ccbaccbcdcb	TRUE
cdabbbcdcbc	TRUE
cdabbbdbccd	TRUE
cdcbabbbbbc	TRUE
cdcbadccbbb	TRUE
dabcbdcdbbd	TRUE
dabcbddbddb	TRUE
dadccbbcdcd	TRUE
dadccbcbdbc	TRUE
dbbdddabcdd	TRUE
dbcabbbbbdb	TRUE
dcacbdcbcdb	TRUE
dcacbddcccc	TRUE
dccddcdabbb	TRUE
dcdabbbdddc	TRUE
ddbbcdddacb	TRUE
ddbbdacbdcc	TRUE
aaaaaaadcbc	FALSE
aaaaaddcadc	FALSE
aacbcaccacd	FALSE
aacbcadddba	FALSE
abbaacabccd	FALSE
abbaadaaadd	FALSE
abdcbadbbac	FALSE
abdcbadddcc	FALSE
accabbaadba	FALSE
accabbadcba	FALSE
adabccaabdb	FALSE
adabdaacccc	FALSE
adcdabbcbdd	FALSE
adcdabcddca	FALSE
babadcdccdb	FALSE
babbaadbcdd	FALSE
baddbddbadc	FALSE
baddcadccad	FALSE
bbccaacadca	FALSE
bbccabcdcac	FALSE
bcbbadbbbac	FALSE
bcbbbadcaaa	FALSE
bcddcbcadda	FALSE
bcddccbacda	FALSE
bdcbdaddcad	FALSE
bdcbddaadcd	FALSE
cabaccbaabc	FALSE
cabaccbdaad	FALSE
cadccbcccad	FALSE
cadcccababa	FALSE
cbcbcdadbca	FALSE
cbcbcdbbdaa	FALSE
ccbbbccadca	FALSE
ccbbbdbcaac	FALSE
ccdbdcdabba	FALSE
ccdbddaaacb	FALSE
cdbdcdbdbaa	FALSE
cdbddbbcada	FALSE
daacaadaadd	FALSE
daacacbbaab	FALSE
dadaaccaada	FALSE
dadabbbbbab	FALSE
dbbccbcccaa	FALSE
dbbccbddada	FALSE
dbdddcdaadd	FALSE
dbdddddbdaa	FALSE
dccccbabbca	FALSE
dccccbbacba	FALSE
ddbbabddbda	FALSE
ddbbaccadaa	FALSE
abbbbbcddccd	TRUE
abbbbbdcdddb	TRUE
abccbbdbbbcc	TRUE
abccbbdcbcdd	TRUE
abddcbcbddbb	TRUE
abddcbdcbdbc	TRUE
accbdcdddbdc	TRUE
accbddbbccbd	TRUE
acdcddbdbcdc	TRUE
acdcddbdddbc	TRUE
adbddccbbbdd	TRUE
adbddcccddcc	TRUE
addbdbdcdbcd	TRUE
addbdcbbbdbb	TRUE
babddbddccbc	TRUE
babddccbccdc	TRUE
bbabbbddbbdd	TRUE
bbabbcdcdbdc	TRUE
bbcddbddbcdc	TRUE
bbcddcabdbbc	TRUE
bcbbcbdabbdc	TRUE
bcbbccaccbdc	TRUE
bcddbdcacdcd	TRUE
bcddcabcbdbc	TRUE
bdcccadbdddb	TRUE
bdcccbabccbc	TRUE
cabdcccbbdbd	TRUE
cabdcccbcbdb	TRUE
caddbdccdcdc	TRUE
caddbdcddbcb	TRUE
cbcacdbbcbbb	TRUE
cbcacddbbdbc	TRUE
ccadbcbbdbdb	TRUE
ccadbcbcdbcd	TRUE
ccdbbdbcaccd	TRUE
ccdbbdccccdb	TRUE
cdcacbbbbdcb	TRUE
cdcacbbbdcdb	TRUE
dabccbcbdccb	TRUE
dabccbdbddbb	TRUE
dadccbccddcd	TRUE
dadccbdbcbcc	TRUE
dbbdadddddcb	TRUE
dbbdbbbdabcb	TRUE
dcaccdbbdcdb	TRUE
dcaccdcbbbdb	TRUE
dcdacbddcbbb	TRUE
dcdaccdcbdcb	TRUE
ddbccccbadbd	TRUE
ddbcdbccabbb	TRUE
aaaaaabaddcd	FALSE
aaaaabdddddb	FALSE
aacccdccdada	FALSE
aacdaaaabadc	FALSE
abbccccabdad	FALSE
abbcccdbbbda	FALSE
acaaabddabba	FALSE
acaaadaadddc	FALSE
accccbacbacc	FALSE
acccccbbcdab	FALSE
adadccdacdbb	FALSE
adaddaabcaac	FALSE
adddbccabbad	FALSE
adddcacdddaa	FALSE
baccbdaacdbc	FALSE
bacccaacccab	FALSE
bbbaadbdaadd	FALSE
bbbabaaaaada	FALSE
bbddbcacbbaa	FALSE
bbddbcbbabba	FALSE
bccbcdddaaad	FALSE
bccbdabacaca	FALSE
bdaddaadacdd	FALSE
bdaddacbbdac	FALSE
bddcdcbbcdaa	FALSE
bddcdccadbca	FALSE
cacadbbddada	FALSE
cacadbcdcaad	FALSE
cbacdabccabb	FALSE
cbacdadbbdba	FALSE
cbdacbacbcac	FALSE
cbdacbdccbda	FALSE
ccbccaaaddaa	FALSE
ccbccaadcadc	FALSE
cdabbcbbbcba	FALSE
cdabbcdadcca	FALSE
cdccadcbddab	FALSE
cdccbadacccb	FALSE
daaddacdcdbb	FALSE
daaddcbacacd	FALSE
dadccdbdbbba	FALSE
dadcdaabdbda	FALSE
dbcbcaaccddc	FALSE
dbcbcbccdada	FALSE
dcadaacbcbad	FALSE
dcadabcdadca	FALSE
dcdbadbcbbba	FALSE
dcdbadccdcca	FALSE
ddbcbbbbbdaa	FALSE
ddbcbcbadbda	FALSE
abbbbbbbbdbbd	TRUE
abbbbbbddbdbc	TRUE
abccccdcdbdbc	TRUE
abcccdbbbbccd	TRUE
acbbbdbdcbbdd	TRUE
acbbbdccbbbdc	TRUE
accccdbcbcddd	TRUE
accccdcdcdcbb	TRUE
acddddcbdcdcb	TRUE
acddddcccddbc	TRUE
adccbcbcdbcbb	TRUE
adccbcccdbcbc	TRUE
addddbdbdcdcc	TRUE
addddbddcdbcb	TRUE
bacddbbddbcdd	TRUE
bacddbcbbccbd	TRUE
bbaddcddcbccd	TRUE
bbaddddbcdccd	TRUE
bbdccdacccbbd	TRUE
bbdcdbcbaddbb	TRUE
bccbcdadcbcbd	TRUE
bccbdbcaccccb	TRUE
bdbadbdcbdccb	TRUE
bdbadbdcddbdd	TRUE
bddccbcdbdadc	TRUE
bddcccacdcccc	TRUE
cacccddbbbddb	TRUE
caccdbcbbbdbb	TRUE
cbaccdbcbbdcc	TRUE
cbaccdbccddbd	TRUE
cbcdcaddbdbbd	TRUE
cbcdcbccddcbb	TRUE
ccbbddaddbcbb	TRUE
ccbcabcbbccbb	TRUE
cdabbcdbbdbcb	TRUE
cdabbdbbdbcbc	TRUE
cdccbbcbdcadb	TRUE
cdccbbddacdcd	TRUE
dabdccdcdbcdb	TRUE
dabdccddcbbdd	TRUE
daddbcccccbbd	TRUE
daddbcdbbbbcc	TRUE
dbbdbdbdabbdc	TRUE
dbbdbdddabcbb	TRUE
dcaccdddbbbdd	TRUE
dcacdbbbdddcc	TRUE
dccdcacbcccdd	TRUE
dccdcacbcdbdb	TRUE
ddbbcacdbdbcd	TRUE
ddbbcbacbccbd	TRUE
aaaaaabaddcdd	FALSE
aaaaabddddbbc	FALSE
aacccaabdadba	FALSE
aaccccbdbbccc	FALSE
abbbbcabcddbd	FALSE
abbbbccccbaaa	FALSE
acaaabbbcbcbd	FALSE
acaaabccadcac	FALSE
acccddacdbbcb	FALSE
accdaadcbadbc	FALSE
adbadabbcccac	FALSE
adbadcacbabcd	FALSE
adddadbbdacbb	FALSE
adddadcbabcac	FALSE
baccbbddacbcd	FALSE
baccbcccbddda	FALSE
bbbbcaccdacdb	FALSE
bbbbccbcaddba	FALSE
bcaaadcaadbad	FALSE
bcaaaddbdccbb	FALSE
bcccdbbbdcdaa	FALSE
bcccddaaabdab	FALSE
bdbadcbcbbcab	FALSE
bdbadcddabdbc	FALSE
bddcccbbdaaba	FALSE
bddccccbddcaa	FALSE
cacbbbbddbcda	FALSE
cacbbcbbbcabc	FALSE
cbadabadbccad	FALSE
cbadabbdcadaa	FALSE
cbdbcddccbcaa	FALSE
cbdbdabaaabbc	FALSE
ccbdcacadbbac	FALSE
ccbdcbbaaacad	FALSE
cdaaccbbaddcd	FALSE
cdaacdabbbadb	FALSE
cdccddbcbcbaa	FALSE
cdccddcdddaca	FALSE
dabbbdabdccca	FALSE
dabbcadbcddcb	FALSE
dadccaddabacc	FALSE
dadccbbbbddda	FALSE
dbcadbadcbbcb	FALSE
dbcadcacbcbaa	FALSE
dcacdacaaaacd	FALSE
dcacddcddbdba	FALSE
dcdabbabddaba	FALSE
dcdabdadabaca	FALSE
ddbcabaacbadc	FALSE
ddbcacbdabbbb	FALSE
abbbbbbcdbcdcd	TRUE
abbbbcbbdccbbd	TRUE
abccbcbccdbcdd	TRUE
abccbcbcdbcbdd	TRUE
abddbdbccccbcc	TRUE
abddbdbcddbdcc	TRUE
accbcbccbbbbdc	TRUE
accbcbccbdcdcd	TRUE
acddbbdbcdcdcd	TRUE
acddbbddbcdbcd	TRUE
adcbccdbcdbcdd	TRUE
adcbccdbdbbdcd	TRUE
addcdbcdcddcdb	TRUE
addcdbdbdcdddd	TRUE
bacbddbdbcddbd	TRUE
bacbddbdccdbcc	TRUE
bbaccdbbcdddbb	TRUE
bbaccdbdbdbcbc	TRUE
bbdadcbbcdbccb	TRUE
bbdadcbbdddddd	TRUE
bcbcdacbccbdbd	TRUE
bcbcdacbddcddc	TRUE
bcddbcdbdacbcb	TRUE
bcddcacdbdbbcc	TRUE
bdcbabbbcdddbb	TRUE
bdcbaccbbcccbd	TRUE
cabccdcbdccddc	TRUE
cabccddccbdbcd	TRUE
cadccdcbcbbccb	TRUE
cadccdcccbbbcd	TRUE
cbbdcdbadcbdbd	TRUE
cbbdcdbbdbcccb	TRUE
ccacccddcdbbbc	TRUE
ccaccddccdcbcd	TRUE
ccdbadbccdcdbb	TRUE
ccdbadbdbdccbb	TRUE
cdbdbabcbccdcb	TRUE
cdbdbbacbcdddb	TRUE
dabbddbcbcbccb	TRUE
dabbddcdbbdcbb	TRUE
dadbcdbbdcbcbd	TRUE
dadbcdbcddbcbd	TRUE
dbbbbbabbdbcbd	TRUE
dbbbbbabcdccdc	TRUE
dcabcdcbcbcbdc	TRUE
dcabcdccddbccd	TRUE
dcdabbccbbbcbb	TRUE
dcdabbdbbddcbc	TRUE
ddbbbccdddbadd	TRUE
ddbbbdaccdbdbd	TRUE
aaaaaabcbbaaad	FALSE
aaaaabbccacbab	FALSE
aacbdbccbacada	FALSE
aacbdcbbbbcbba	FALSE
abadbcabccbbca	FALSE
abadbcdaaabdbb	FALSE
abdcdcbdbaaaad	FALSE
abdcddbabdcbab	FALSE
accadbadccdacb	FALSE
accadbcaaccccd	FALSE
adadacbbcaabbd	FALSE
adadadcbacbbdc	FALSE
addbacaddccbad	FALSE
addbadccaabdba	FALSE
babdbcacbaddba	FALSE
babdbcaccadcbd	FALSE
bbabbbadacbadb	FALSE
bbabbbccdbddda	FALSE
bbccdcddccadba	FALSE
bbccddaabbcabd	FALSE
bcbbdaadcdbaad	FALSE
bcbbdacbddbcac	FALSE
bcddddcddcacca	FALSE
bcdddddadabbdb	FALSE
bdccbaaadacaab	FALSE
bdccbadaccaadc	FALSE
caacddcabbacda	FALSE
caadaaccdbdcad	FALSE
cadbacbccaccbb	FALSE
cadbadbcbaabca	FALSE
cbbdddbddcadda	FALSE
cbbdddddabbcad	FALSE
ccabdacacdcbab	FALSE
ccabdaccdaacdc	FALSE
ccdaaccaabcdbb	FALSE
ccdababcaccdba	FALSE
cdbcdabaacadca	FALSE
cdbcdadbbdabad	FALSE
daabdabccdccac	FALSE
daabdccabacdcb	FALSE
dacddcaabdacdb	FALSE
dacdddbddcabbb	FALSE
dbbcabdcabdcbb	FALSE
dbbcacdadadccc	FALSE
dcaabcabddbcca	FALSE
dcaacadbadcaab	FALSE
dccccddcbdadad	FALSE
dcccdadcccaadc	FALSE
ddbbcdcababaad	FALSE
ddbbdaaddadaca	FALSE
abbbbbbccddbbbb	TRUE
abbbbbbdbcdcccd	TRUE
abcccbdcdbdccdd	TRUE
abccccbdbcdbbdb	TRUE
abddcddccbcdddc	TRUE
abddcddcccdbcdc	TRUE
accbccbbcccbddd	TRUE
accbcccbbddbbbc	TRUE
acddbcdbddccbbb	TRUE
acddbcddccccddb	TRUE
adcbbdcdbbbdcbd	TRUE
adcbbddbccdbcdc	TRUE
addccbdbdcbcdbc	TRUE
addccbdccbbbbcb	TRUE
bacbcdcbccbdddc	TRUE
bacbcdcddccbddd	TRUE
bbacccdbbcddbbc	TRUE
bbaccddcdbbdbdc	TRUE
bbdabbbdbdccddc	TRUE
bbdabbdcbdcdbcc	TRUE
bcbbdcddaccbcbd	TRUE
bcbcabbcbddbbbb	TRUE
bdaccbbcdbcccdb	TRUE
bdaccbcbbbdcbcb	TRUE
bdcdaccdcdbcbdc	TRUE
bdcdadbbbdbcdbb	TRUE
cabdcdddcdbbbdc	TRUE
cabddbcccbcbddc	TRUE
caddcdcdbcbdccd	TRUE
caddcddccdccdbb	TRUE
cbcbaccbbddbccd	TRUE
cbcbaddbcddbccd	TRUE
ccadbccdddbcdcb	TRUE
ccadbcdbcbbdbbc	TRUE
ccdadbbdbcbcdbc	TRUE
ccdadcbbbddcdbc	TRUE
cdbcdabbbbbcbcd	TRUE
cdbcdabbdcbcdbb	TRUE
dabbcbcbbdcbdcc	TRUE
dabbcbcbcbcdbbb	TRUE
dacddcbccbdbdcc	TRUE
dacddcbddbcdbcc	TRUE
dbbbbcddcddabcc	TRUE
dbbbbdaddccbcdc	TRUE
dcabbddcdddddbc	TRUE
dcabcbbbbccbbbc	TRUE
dccccadccccbbdb	TRUE
dccccbcacdbcccb	TRUE
ddbbcdbadbdcbcd	TRUE
ddbbdadddbdcdcd	TRUE
aaaaaccdcadcddd	FALSE
aaaaadbbcdcbcab	FALSE
aacccacddacacad	FALSE
aacccbbcbcaccda	FALSE
abadcbdcdbddaac	FALSE
abaddbadcdbacca	FALSE
abdbddbdcccbbba	FALSE
abdcaabbcbcdcdd	FALSE
accaacabdddbdbb	FALSE
accaacaddddbdbd	FALSE
adacccadbdacbac	FALSE
adaccdabaccbbcd	FALSE
addaaddbcabdcbd	FALSE
addabdcaacaabaa	FALSE
babdacbdaabdadd	FALSE
babdaccacbcabdd	FALSE
bbababcbbdcdacb	FALSE
bbabacbaacbabcd	FALSE
bbdbaddcccdbbaa	FALSE
bbdbbaaccbaabba	FALSE
bcbddcdaadbdccd	FALSE
bccaaaacdacaccc	FALSE
bdaadcbaadbccda	FALSE
bdaadcbabccaccb	FALSE
bdccacdaadbbccd	FALSE
bdccadacbdabaac	FALSE
cabbabbddcddbbb	FALSE
cabbabcbabcdbac	FALSE
cadacdacaacbcab	FALSE
cadacdccaaaccdb	FALSE
cbbdbdbdacaadbb	FALSE
cbbdcaadcdccbdb	FALSE
ccacdbdcbcaaabb	FALSE
ccacdcdabbbdbad	FALSE
ccdadcacdadddcb	FALSE
ccdadcbbabdcdbb	FALSE
cdbcddaadbaddda	FALSE
cdbdaadcccbdbdd	FALSE
daaabbbcdbbccda	FALSE
daaabbdabbaabbb	FALSE
dacbdacbbabccba	FALSE
dacbdcccccaaccd	FALSE
dbbacaabcdccaad	FALSE
dbbacacaddcbcbd	FALSE
dbddadadcadcdad	FALSE
dbddadbddadbdab	FALSE
dccbbdabcdbcabd	FALSE
dccbbddbcdccdaa	FALSE
ddbaacdcbcacddc	FALSE
ddbababdbaabdda	FALSE
abbbbbbccddbbbbb	TRUE
abbbbbbdcdcccddc	TRUE
abcccbdbcdbdcddd	TRUE
abcccbdbdbdccbbd	TRUE
abddcdcbcdcbdcbb	TRUE
abddcddcbcdcbdbc	TRUE
acccbbbbdbcdcccc	TRUE
acccbbbbdccdbddd	TRUE
acddbdbccccbdcbb	TRUE
acddbdbcddcbbddd	TRUE
adcbbcbdcbccdbcd	TRUE
adcbbcccbcbccdcc	TRUE
addccddbcbdbbbbd	TRUE
addccddbdbddcbbb	TRUE
baccdccdccbdddcc	TRUE
baccdccddbcdccbb	TRUE
bbadbccbbbdbdbdd	TRUE
bbadbcdbcbcdbbdd	TRUE
bbdbacbbbbdbcdcc	TRUE
bbdbadccbcbbdccd	TRUE
bcbddaccdbdbddbd	TRUE
bcbddacddbddbcdb	TRUE
bdacccbbbbbdddbb	TRUE
bdacccbbbcddddbb	TRUE
bddabcddcdbbcbcb	TRUE
bddabdcccdccddcb	TRUE
cabddcdbdbbcdddb	TRUE
cabdddbdbcbdbbdc	TRUE
caddcdddcccdbddc	TRUE
cadddbcbdbcbbbcc	TRUE
cbcbdacbdbcdcdbd	TRUE
cbcbdbbddabdbddd	TRUE
ccadcbbbbcddcdcc	TRUE
ccadcbbdbccdbbdd	TRUE
ccdadbdbbcbdcdbb	TRUE
ccdadbdbddbbdcdb	TRUE
cdbbbdcbdcabdccd	TRUE
cdbbbddcacbbbdbd	TRUE
dabbbdddcdbdbdcd	TRUE
dabbcbccdbdcdbbd	TRUE
dadbcbcbdddbcdbd	TRUE
dadbcbdbbdcccbbb	TRUE
dbbbcbadccbdcbdc	TRUE
dbbbcbcadddbbbcb	TRUE
dbddcdbabdcccddb	TRUE
dbddcdbcbdbadbbb	TRUE
dccbdcdbdcccbcab	TRUE
dccbdcddbdacdccb	TRUE
ddbacdddcbddcccc	TRUE
ddbadbccdddccdbb	TRUE
aaaaaabbacdcbddd	FALSE
aaaaaabdbdaccbdc	FALSE
aaccbabdcacdcaab	FALSE
aaccbacabaaaabac	FALSE
abaddbbcdbbdcbcd	FALSE
abaddbbdaddddabb	FALSE
abddacaaddabacdb	FALSE
abddacabdcddcdca	FALSE
accbabdccbcaabab	FALSE
accbacbdbbdacbab	FALSE
adbadddbdddaccdd	FALSE
adbbaabbcababadb	FALSE
addcbbcccccacddc	FALSE
addcbcabcaacdadb	FALSE
bacbdadbacddbbaa	FALSE
bacbdbddcaccbcdc	FALSE
bbbaddabdcbcdcdb	FALSE
bbbbaaaccdbcdabc	FALSE
bbdccddacbddacbb	FALSE
bbdcdabdcccdadba	FALSE
bccbacdbaacacdcb	FALSE
bccbbaaabbdccbbd	FALSE
bdadccabdcccdcaa	FALSE
bdadccbaddbbcaab	FALSE
bddacccbdbcdcdab	FALSE
bddacdaaaacbaaaa	FALSE
cacaabbbcddacdaa	FALSE
cacaabcaddbaccad	FALSE
cbadabbacdcacabb	FALSE
cbadacdcccdcdddb	FALSE
cbdaadddaaacdddc	FALSE
cbdababadaaacdcc	FALSE
ccbbdcacabcdadda	FALSE
ccbbdcbacdabccba	FALSE
ccddbbdcdaacdaca	FALSE
ccddbcaabadcbbdc	FALSE
cdcadccdbcbacdac	FALSE
cdcadcdcdbdaadaa	FALSE
daabdbcbabcbcbad	FALSE
daabdcbcadbdbbda	FALSE
dadadadbdbadaccd	FALSE
dadaddccccabacbb	FALSE
dbbdbaacddddcbcd	FALSE
dbbdbabadadacbbd	FALSE
dcabccacccccadba	FALSE
dcabccadaccadbdc	FALSE
dccdbaaaacbbcddb	FALSE
dccdbbbbabadaaad	FALSE
ddbadbbbdbbacbcc	FALSE
ddbadbcabcdcbbda	FALSE
abbbbbbddccbbcbbd	TRUE
abbbbbcdcbcdbdbbc	TRUE
abccbdccbbcdcddcc	TRUE
abccbdcccdcbdccbb	TRUE
abddcdddbbbdddbdb	TRUE
abddcdddcdcdbcdcd	TRUE
accbdbcccbddccddd	TRUE
accbdbcddbbcccbdb	TRUE
acddccddbdbdccdbd	TRUE
acddcdbbdcbbbdbcc	TRUE
adcbcdbcdcbcbddcb	TRUE
adcbcdbddccbbdbdd	TRUE
adddbcbbdbdcbbddb	TRUE
adddbcbddbbdbbccd	TRUE
baccdbdddbdbcddcc	TRUE
baccdbdddccbccdbd	TRUE
bbacddcdddbbcbbbc	TRUE
bbacdddbbccbbcbcc	TRUE
bbdcaccdcdccdbbcc	TRUE
bbdcacdddbddbbbbb	TRUE
bccadbbbbbdcbbdbb	TRUE
bccadcbbcdddcddbc	TRUE
bdadbbdbbcccddccb	TRUE
bdadbbdcdcdbddbbb	TRUE
bddbdcabcbcbdcdcd	TRUE
bddbdcabcdccbbbcb	TRUE
cacccbbcccbccdbbd	TRUE
cacccccccbbbbcbdc	TRUE
cbaccccccbdbbcbbc	TRUE
cbaccccdbcddbdbcb	TRUE
cbcdcacbcdcccbdcd	TRUE
cbcdcacdddbdbcdbd	TRUE
ccbbdadcbdbdddbcb	TRUE
ccbbdadcdddbddcdc	TRUE
ccdcdabbddddddbcb	TRUE
ccdcdadcbdcdbbccd	TRUE
cdcabdcdbcccbbddd	TRUE
cdcacbbbdddccbbdb	TRUE
dabbddbdbddbbdddb	TRUE
dabbdddbccbcccdbd	TRUE
dacddcbcbcccdcbdc	TRUE
dacddcbdbdbbdcdbc	TRUE
dbbbccbaccdccbcbb	TRUE
dbbbcccadcdcdbddd	TRUE
dbddbbbbbddcbacdd	TRUE
dbddbbcadbcccbdbc	TRUE
dccbdbcadddcdcdcd	TRUE
dccbdbcdbbabbdddc	TRUE
ddbbcbddabcdbbbbc	TRUE
ddbbccbadbcbdbbdb	TRUE
aaaaacdbbbbaaaaca	FALSE
aaaaacdbdcabdbaba	FALSE
aaccabaaaaacaddbc	FALSE
aaccabbbbadacaddb	FALSE
abbadccacacccbcbd	FALSE
abbadccdabacdddba	FALSE
acaababbadadcdbdb	FALSE
acaabbdaadaaacccc	FALSE
acccccacdbcacdccd	FALSE
accccdbadabccacac	FALSE
adbacdddbdccbaacb	FALSE
adbadaccdddaabddb	FALSE
addcaaddcbabcadbc	FALSE
addcabddbdbbbbabd	FALSE
bacadabadbbdbcbbb	FALSE
bacadabbcccbaaabb	FALSE
bbacabbcaacdbcbbb	FALSE
bbacabdbabaabddbb	FALSE
bbdaadcdbdbdcbbab	FALSE
bbdaaddadcbcadbba	FALSE
bcbcdaacbbcacbbab	FALSE
bcbcdababddcbadab	FALSE
bdaabccdbdadabddb	FALSE
bdaabdcddcbaacbad	FALSE
bdccdcddbddbbbcaa	FALSE
bdccddbbacbccbcca	FALSE
cabbdaabbddacbbaa	FALSE
cabbdabbaddacdcbc	FALSE
caddabcbadcbacbdc	FALSE
caddacdcaccbddbdb	FALSE
cbcabbdcbabbddbcc	FALSE
cbcabcdcdbbcabbda	FALSE
ccadadadbaaabddbb	FALSE
ccadadcabdcaabcbd	FALSE
ccdbbdccdaaacbddb	FALSE
ccdbbdddccccaacba	FALSE
cdbddbacbadacdcac	FALSE
cdbddbddddbdcbcaa	FALSE
daaadbccbacbdcbcd	FALSE
daaadbdabbdcdbacd	FALSE
dacdbdcaddcdbbdcc	FALSE
dacdcbdcaadccaaba	FALSE
dbbbddbbbdddbbbaa	FALSE
dbbbddcababdddbda	FALSE
dcaaabbcbadbddbaa	FALSE
dcaaabdacddcbcacc	FALSE
dcccbdccccaacaddb	FALSE
dccccaaabcacdcaab	FALSE
ddbbdbbadaabaaccc	FALSE
ddbbdbcaadbbddaba	FALSE
abbbbbbbbcdcddcbbc	TRUE
abbbbbbcdcbdbdbdcc	TRUE
abccbbbdbcdcbbbbdc	TRUE
abccbbcbbddbcbdbcd	TRUE
abdddbdbcbbddccdcb	TRUE
abdddbdccccdbbcbbd	TRUE
acccbbddcbbdcbdddb	TRUE
acccbbddcbbdddbbbb	TRUE
acdddbdbcdbddcbcbb	TRUE
acdddbdbddcddbdbbb	TRUE
adcbdcccdddbccdbcb	TRUE
adcbddbcbcdddbdbbb	TRUE
adddbbdbbcbbdbbbcc	TRUE
adddbbdcccccbcdbbb	TRUE
bacccdcbcddccddccd	TRUE
bacccdcbdddccddbbd	TRUE
bbabddcbbbcbdbdcbb	TRUE
bbabdddbbbbbcbbbbc	TRUE
bbcdcdacbddbddcddb	TRUE
bbcddacbbdcdcbbdcc	TRUE
bcbccbabbcbddbcccd	TRUE
bcbccbbadcdcdbddcb	TRUE
bdabbccddccbdbdbcc	TRUE
bdabbcdbddcdcbdccb	TRUE
bdcbdbccdaddcdbdcd	TRUE
bdcbdcdbcbbcbbdacc	TRUE
cabdbddbcdbdccbbcb	TRUE
cabdcbbbbcdbdcdbdb	TRUE
cadcddcccdccbcdbdd	TRUE
cadcddddcccbbccddc	TRUE
cbcacddcbcbdbdcccc	TRUE
cbcadbccddcbbccccd	TRUE
ccadccbdbdcbbdbddc	TRUE
ccadcccbcbbdbbcdcb	TRUE
ccdbccccacbcdbdcdb	TRUE
ccdbdabddcbdbcbbbd	TRUE
cdbdadddbbbdbdddbc	TRUE
cdbdbabdccdcbbccdc	TRUE
dabbccbccdcbcbbcdc	TRUE
dabbccccdcbbdcccdb	TRUE
dacddddbcddddcbbdc	TRUE
dacddddcbcccccbbbb	TRUE
dbbacdccdcccdccccb	TRUE
dbbadbbbdccdcddccc	TRUE
dbddbdbbdbbdccbbca	TRUE
dbddcabbcbcbdbcdbd	TRUE
dccbcbdbacdbbdcddc	TRUE
dccbccbadbbccdbdbc	TRUE
ddbadbdbcddcbcdcdd	TRUE
ddbadbdddbbdcbddcd	TRUE
aaaaadaabbbdbdddca	FALSE
aaaaadacdbdacabbda	FALSE
aacbadcacddddaadcb	FALSE
aacbaddcaacdabaaac	FALSE
abbababcbcabacacba	FALSE
abbabcaabbbcddaadb	FALSE
abdcadcabbccacccdb	FALSE
abdcbacabcddbaaddd	FALSE
accacaacbdaaddcaab	FALSE
accacabdbaddcdadda	FALSE
adabdccdadbdcadabb	FALSE
adacaabcaccaadcddc	FALSE
addaabcdcbcabbbcda	FALSE
addaabdacdbcbadbcc	FALSE
babcdcacccbbaddcdd	FALSE
babcddaabbdbdcbcca	FALSE
bbaaccbdacaabadabd	FALSE
bbaacdaddccaddaaaa	FALSE
bbcdababdcadccccab	FALSE
bbcdbabcdaacdadbac	FALSE
bcbbcbbccbccdbaacb	FALSE
bcbbcbdbabdcbbcacb	FALSE
bcdcddcaaadcccbcdd	FALSE
bcdcddcabddbbdcadc	FALSE
bdcadcbbdccabdadcb	FALSE
bdcaddbcdcacabbbab	FALSE
caadcdddbcbdbbdbcd	FALSE
caaddabacdcaadaccc	FALSE
cadbcdabbcacbabcaa	FALSE
cadbdabdacabcabbdc	FALSE
cbcbbccdcbdbbdcdaa	FALSE
cbcbccabdaccacbaca	FALSE
ccadcabdbdcbbcddba	FALSE
ccadcacdbbbcadbcab	FALSE
ccdccabbcdcbdaaaac	FALSE
ccdccacacbcdaacbcc	FALSE
cdcabacdbdcadcbbcd	FALSE
cdcabbaabcbccbacad	FALSE
daaccbbbbdbcddabcc	FALSE
daacccdabbbaccdbdd	FALSE
dadbaaaadcccdccbbd	FALSE
dadbaaadcacdbbabba	FALSE
dbbdbdbcacadbbbbab	FALSE
dbbdcabcdabddcbcbb	FALSE
dcabacbcddbddccadb	FALSE
dcabbcdbccdcaacbba	FALSE
dcccddbdccbcbcacba	FALSE
dcccdddabacbcadbda	FALSE
ddbbbadddccdcaabca	FALSE
ddbbbbbcbcaacccbac	FALSE
abbbbbbddccbbbbbcdd	TRUE
abbbbbccccbcbcbbbbb	TRUE
abcbdcddbbccdcbdddb	TRUE
abcbddbbddccbccbccb	TRUE
abddbcccccccbdcdccc	TRUE
abddbcdcbcdcbdbbbbc	TRUE
accbcbbddcddbcdcbcc	TRUE
accbcbcbccccccddbdc	TRUE
acdcdbbccbdccccdbdd	TRUE
acdcdbcdcddccccccbb	TRUE
adbdcdcccdcccbcbbbc	TRUE
adbdcdccdbccbbcbdcc	TRUE
addbdbccbbcdcdbcdcd	TRUE
addbdbcdbdbdbdddbcd	TRUE
bacbbbdbdddccdccdbc	TRUE
bacbbbdcdccdbdcbbbd	TRUE
bbabddcbcbcdbbbbbdd	TRUE
bbabddcccbccddcbcdd	TRUE
bbcdbbadbdbcbbcdcdc	TRUE
bbcdbbbabbccdbbccdc	TRUE
bcbbdcdcdabbcddbdcd	TRUE
bcbcabcdcdbbdbcbbbb	TRUE
bdabbbcccbbbcdcdbdb	TRUE
bdabbddbcdcdddbdccc	TRUE
bdcddacdbbdbccccbbb	TRUE
bdcddadbccbcdbbbbcb	TRUE
cacbccbdccddcbccdbc	TRUE
cacbccbddbbcbcdbbbb	TRUE
cadddcdcbcddbbcccbc	TRUE
cadddcdcdbcccdcccdd	TRUE
cbccbabcdccdbbbbdbb	TRUE
cbccbadbddccccbdcdd	TRUE
ccadccbbdccbcbbdbdb	TRUE
ccadccccbbbdbbbcccc	TRUE
ccdcacdccdddcbcbccc	TRUE
ccdcaddbcdccdcccbcc	TRUE
cdcacdbbcdcbdddcbdd	TRUE
cdcacdbccccdbcdddbc	TRUE
dabcbbbbbcbccdbbbcb	TRUE
dabcbbbdbcbdbdcbcbb	TRUE
dadbcddbdbddbbbddcc	TRUE
dadbdbbbcdbcccbbddc	TRUE
dbbbcccbdadddccbcbb	TRUE
dbbbdabbcccbccddbbc	TRUE
dbdddacdbccbccdbdcd	TRUE
dbdddacdbdddbdbcddc	TRUE
dcccdcaccbbdbcbdcbb	TRUE
dccdabddbbbbcdbbddd	TRUE
ddbcbacbdcbbcbdbbcd	TRUE
ddbcbbcbdcacddccbdd	TRUE
aaaaaaaabbaabcbaacd	FALSE
aaaaaadbcbccdabccdc	FALSE
aaccdbdcaddbdabcbac	FALSE
aaccdccbccaddcbadaa	FALSE
abbadbccbcbcdacbbad	FALSE
abbadbdcccccdcbabbd	FALSE
abdcbbacadcaccccada	FALSE
abdcbbbcdcbbbaaccaa	FALSE
acbdddbdbabadaaaacc	FALSE
accaaaabbcdbcbcdcbb	FALSE
adabcdaacdbbccabcda	FALSE
adabdacbacccbabcbda	FALSE
adcdbdbbbadcdbadbdd	FALSE
adcdbdbbdcbcdaacabd	FALSE
babccdbdbadcdadcadd	FALSE
babccdcdabbbacabcdd	FALSE
bbaaccadacdbdbcbbab	FALSE
bbaadadaabaccbbaccb	FALSE
bbccbaaacdddaacbdcd	FALSE
bbccbbbdcacdbcbbbba	FALSE
bcbadcaddcbccdacaad	FALSE
bcbbabacddadcdcabaa	FALSE
bdaacbaddbcddadadcb	FALSE
bdaacbcccadcdaddabc	FALSE
bddaadcbdcadccddbca	FALSE
bddaaddbabaddbbccdd	FALSE
cabcaabadadbdccdaab	FALSE
cabcaacabddacbabcdd	FALSE
cbababadaaaaddcbcbd	FALSE
cbabacaddcbdbacacaa	FALSE
cbcccbdcbcbadbcbadb	FALSE
cbcccbdcdcbabcdaabb	FALSE
ccbbbabbbabaabcdacc	FALSE
ccbbbacadbcaddbcadc	FALSE
ccdccdbaccdbaccadbd	FALSE
ccdccdbbaaddaabaaaa	FALSE
cdbdccacdaccaacbcda	FALSE
cdbdcccabbdddcdbaac	FALSE
daabbcbcaacacbabccd	FALSE
daabbcbcdbbdaabadca	FALSE
daccdacccbaaccabcaa	FALSE
daccdcbbdcabdaaaaac	FALSE
dbbbbccaacbaaddabab	FALSE
dbbbbdacaadadaccdca	FALSE
dcaadcabbdddadaabdb	FALSE
dcaadcacbbaabbbbbcd	FALSE
dccccbddcdcbdcbcada	FALSE
dcccccbabcbadbbcccb	FALSE
ddbbcbadbbcdadcbbcb	FALSE
ddbbcbcbabddbadccba	FALSE
