aaaaaaaaad	TRUE
aaaaaaaadd	TRUE
aaccacdccc	TRUE
aaccadadca	TRUE
aadddadadc	TRUE
aadddaddad	TRUE
accadccacc	TRUE
accadccada	TRUE
acddaaddca	TRUE
acddacaaaa	TRUE
adcacadcad	TRUE
adcacadcad	TRUE
addccacdac	TRUE
addccadccc	TRUE
bacaacdadc	TRUE
bacaaddadd	TRUE
baddaddcdd	TRUE
baddcaacda	TRUE
bbcbdadcdd	TRUE
bbcbdbbbdc	TRUE
bcacddcacc	TRUE
bcadacaaac	TRUE
bcdadaaaaa	TRUE
bcdadadaca	TRUE
bdbdaaaaac	TRUE
bdbdaadadd	TRUE
caacaaacaa	TRUE
caacaaadaa	TRUE
cadacdcaac	TRUE
cadacdcdca	TRUE
cbbccccdad	TRUE
cbbccccddb	TRUE
ccaacccaca	TRUE
ccaacccacc	TRUE
cccdddacaa	TRUE
ccdaaaacdd	TRUE
cdbccbcaca	TRUE
cdbcccbbbc	TRUE
daaaaccadd	TRUE
daaaacccac	TRUE
dadaccaadd	TRUE
dadacccddc	TRUE
dbbcccaaad	TRUE
dbbcccacca	TRUE
dcaaccddaa	TRUE
dcaacdaddc	TRUE
dccdbadacc	TRUE
dccdbbcbca	TRUE
ddbbdbaddc	TRUE
ddbbdbbacd	TRUE
aaaaaabaaa	FALSE
aaaaaabadd	FALSE
aaccbabacb	FALSE
aaccbbbcbb	FALSE
abadcdbbbc	FALSE
abaddacdbc	FALSE
abdcaacaab	FALSE
abdcababdc	FALSE
accabcdcda	FALSE
accabdaabd	FALSE
adadabaadb	FALSE
adadabcccb	FALSE
addbdbcaac	FALSE
addbdbddcd	FALSE
babdacaaaa	FALSE
babdbaadaa	FALSE
bbabacbcac	FALSE
bbabaccaac	FALSE
bbccdabbda	FALSE
bbccdacbab	FALSE
bcbbaacabc	FALSE
bcbbabbada	FALSE
bcddcacadb	FALSE
bcddcbcaab	FALSE
bdcadaaccb	FALSE
bdcadacdbc	FALSE
caacdbdaab	FALSE
caacdbdccd	FALSE
cadadaadcb	FALSE
cadadaddab	FALSE
cbbdbcddab	FALSE
cbbdbdbaab	FALSE
ccadbcaabd	FALSE
ccadbcacdb	FALSE
ccdcdabccb	FALSE
ccdcdbadcb	FALSE
cdcadcdaab	FALSE
cdcbaaccdb	FALSE
daacdbadbd	FALSE
daacdcabdc	FALSE
dadcacdbaa	FALSE
dadcacdbbc	FALSE
dbcadbabbd	FALSE
dbcadbbbda	FALSE
dcaccccbab	FALSE
dcaccccbbb	FALSE
dcdaccadcb	FALSE
dcdadcbbcc	FALSE
ddbcbccacb	FALSE
ddbcbcccab	FALSE
aaaaaaadcdc	TRUE
aaaaaaaddda	TRUE
aaccaaacacd	TRUE
aaccaadcdaa	TRUE
aadddacddaa	TRUE
aadddacddcc	TRUE
accaddddaaa	TRUE
accaddddaaa	TRUE
acdcdcdadac	TRUE
acdcdcddccd	TRUE
adcaadaadcc	TRUE
adcaadacddd	TRUE
addcddaacdc	TRUE
addcddadcdd	TRUE
bacccadcdaa	TRUE
bacccaddcdd	TRUE
bbacacddcdd	TRUE
bbacacdddac	TRUE
bbcdbbdcaad	TRUE
bbcdbcccbcb	TRUE
bcbadaccddd	TRUE
bcbadaddcad	TRUE
bcdcbcaaacd	TRUE
bcdcbcacaca	TRUE
bdcaaaccacc	TRUE
bdcaaacccad	TRUE
caacdadacdc	TRUE
caacdadadac	TRUE
caddadaaddc	TRUE
caddadadccc	TRUE
cbcbbccbacc	TRUE
cbcbbcdadcd	TRUE
ccbaaadcacd	TRUE
ccbaaadcdac	TRUE
ccddaadaada	TRUE
ccddacacaaa	TRUE
cdcbacdcaca	TRUE
cdcbadaadcc	TRUE
daacccaadcd	TRUE
daacccccaac	TRUE
dadadacaaca	TRUE
dadadacdcdd	TRUE
dbbcacaadaa	TRUE
dbbcaccaaac	TRUE
dcaacccacac	TRUE
dcaaccccccc	TRUE
dccdcbccbdb	TRUE
dccdccdddbd	TRUE
ddbbaacdadc	TRUE
ddbbaadccda	TRUE
aaaaaabaaad	FALSE
aaaaaabadaa	FALSE
aaccadbbacd	FALSE
aaccbcbccdb	FALSE
abbacacccdc	FALSE
abbacadabcc	FALSE
abdcaaadacc	FALSE
abdcaabddbc	FALSE
accacddbccb	FALSE
accadaaddcb	FALSE
adacbcbaabc	FALSE
adacbcbdbcd	FALSE
addbaccdabd	FALSE
addbadbddbd	FALSE
babdcbdbbdc	FALSE
babdcbddacd	FALSE
bbabaacdacd	FALSE
bbababacdac	FALSE
bbccdddaacb	FALSE
bbcdaacbbcc	FALSE
bcbadaadccb	FALSE
bcbadadbbdb	FALSE
bcdcacadcdb	FALSE
bcdcacbcbab	FALSE
bdcaddbddbd	FALSE
bdcaddddaab	FALSE
caacbabbaab	FALSE
caacbaccdcd	FALSE
cadadababab	FALSE
cadadbdbacc	FALSE
cbbdbddccab	FALSE
cbbdbddddab	FALSE
ccadabccbbb	FALSE
ccadacbcadd	FALSE
ccdcacdccbb	FALSE
ccdcadbbbdd	FALSE
cdcbaaccbcc	FALSE
cdcbaacdadb	FALSE
daacddddbad	FALSE
daadaadaacb	FALSE
dadaadcabad	FALSE
dadabacdaad	FALSE
dbbccbdbacb	FALSE
dbbccbdccab	FALSE
dcabacabbbc	FALSE
dcabbacbcda	FALSE
dccdbccadcb	FALSE
dccdbdaaaba	FALSE
ddbaddabbab	FALSE
ddbbaadbacc	FALSE
aaaaaaadcdcd	TRUE
aaaaaaaddadc	TRUE
aaccaacddcaa	TRUE
aaccaacddddd	TRUE
aadddcacadaa	TRUE
aadddcadcaac	TRUE
accacdacacca	TRUE
accacdacadcd	TRUE
acdcdcdddccc	TRUE
acdcdcddddaa	TRUE
adcaaacdcaaa	TRUE
adcaaadcddda	TRUE
addcdacddcad	TRUE
addcdcccacdc	TRUE
bacccacdcccd	TRUE
bacccaddddda	TRUE
bbaaddaaaaca	TRUE
bbaadddcdada	TRUE
bbcccdcdaacc	TRUE
bbccdaaacadc	TRUE
bcaddccaadac	TRUE
bcaddccadddd	TRUE
bcdbdcadccdd	TRUE
bcdbdccadcdc	TRUE
bdcacadaacdd	TRUE
bdcacadcccdd	TRUE
caaccaaddadc	TRUE
caaccacdcacd	TRUE
cadcadacaada	TRUE
cadcadadaaad	TRUE
cbcaaadadccc	TRUE
cbcaaaddadcd	TRUE
ccaccddadccc	TRUE
ccacdaaaadaa	TRUE
ccdbaccddadc	TRUE
ccdbacdaccdc	TRUE
cdcaddcaccca	TRUE
cdcadddacccc	TRUE
daacccacdaca	TRUE
daacccadaccc	TRUE
dadcacaccada	TRUE
dadcacacccca	TRUE
dbbcdadaadad	TRUE
dbbcdcacddcd	TRUE
dcaadadacddc	TRUE
dcaadcacdcaa	TRUE
dcdaaaadaccc	TRUE
dcdaaacaacca	TRUE
ddbbddbbdbcb	TRUE
ddbbdddacdcd	TRUE
aaaaaadddcab	FALSE
aaaaacabbbaa	FALSE
aacbcaddcdcb	FALSE
aacbcbabccab	FALSE
abbaaccbbaab	FALSE
abbaadabddac	FALSE
abddbdbaabbc	FALSE
abddbdbacdba	FALSE
acccdbaccbcb	FALSE
acccdbbdbadd	FALSE
adbbccbdbcbd	FALSE
adbbcdcdddac	FALSE
adddddbcccdb	FALSE
addddddaccab	FALSE
bacdaccdadab	FALSE
bacdaccdcdcb	FALSE
bbbbbcadcabc	FALSE
bbbbbcbcacdb	FALSE
bbddbcdbbcab	FALSE
bbddcbacaabb	FALSE
bccbdccccdab	FALSE
bccbddbaaaab	FALSE
bdadcbadadbc	FALSE
bdadccabbcdd	FALSE
bddcbdacbcda	FALSE
bddcbddadcbd	FALSE
cacadabbaadb	FALSE
cacadacadaba	FALSE
cbadaccdcabb	FALSE
cbadadbbcddd	FALSE
cbdaacdaaabc	FALSE
cbdaacddcaab	FALSE
ccbcbbaabdab	FALSE
ccbcbbcbaacb	FALSE
ccdddabbbbbd	FALSE
ccdddbaaacbb	FALSE
cdccdaacaccb	FALSE
cdccdbbaddba	FALSE
dabaaadbabcb	FALSE
dabaabaadaac	FALSE
daddaacbadca	FALSE
daddabcdbdca	FALSE
dbcbcaaabbcb	FALSE
dbcbcabdadbb	FALSE
dcbaadbddcdd	FALSE
dcbabaacacdd	FALSE
dcdcacacdcdb	FALSE
dcdcacbadcdd	FALSE
ddbcdcbbabad	FALSE
ddbcdcbbcacb	FALSE
aaaaaacaaaacc	TRUE
aaaaaacacddad	TRUE
aacccccdacddc	TRUE
aacccccdcacac	TRUE
aadddadacadac	TRUE
aadddaddddaac	TRUE
acccaddcadcaa	TRUE
accccaaccacac	TRUE
adaaaccdaaacc	TRUE
adaaacdcadcda	TRUE
adccdccaacdac	TRUE
adccdccaadaac	TRUE
addddddacaccc	TRUE
adddddddccaad	TRUE
bacddddcadcac	TRUE
bacddddcadcdc	TRUE
bbbbadcacccca	TRUE
bbbbadddccddd	TRUE
bbddcbacdcdcd	TRUE
bbddcbdaadaaa	TRUE
bccbcdacdcdca	TRUE
bccbcdcbaadda	TRUE
bdaddcacdaccc	TRUE
bdaddcadcdadd	TRUE
bddccaadaadaa	TRUE
bddccbcccbbdc	TRUE
cacdaaaaddaaa	TRUE
cacdaaacaaccc	TRUE
cbacdadacccaa	TRUE
cbacdcaacdacd	TRUE
cbcdaaaacdcca	TRUE
cbcdacadadada	TRUE
ccbbccdaddccc	TRUE
ccbbcdacaadda	TRUE
cdaaaaacdacad	TRUE
cdaaaadcacdcc	TRUE
cdccdacdacaaa	TRUE
cdccdbbccddac	TRUE
daadcadadcdcd	TRUE
daadcadccacac	TRUE
dadcdccdaccdc	TRUE
dadcdcdaaadda	TRUE
dbcaadadddacc	TRUE
dbcaadddaaaca	TRUE
dcaccaaaaddca	TRUE
dcaccadaacdcc	TRUE
dccdbccddcadc	TRUE
dccdbdcaddaac	TRUE
ddbbcddbaaccc	TRUE
ddbbdaacdacaa	TRUE
aaaaaadddcaab	FALSE
aaaaacbbbaabb	FALSE
aacbdbcacacaa	FALSE
aacbdcccadaab	FALSE
abbaddaaadbbc	FALSE
abbadddcaadbd	FALSE
abddcbddbacca	FALSE
abddccacdbbbd	FALSE
accdacbbbbbdc	FALSE
accdacbcddcbc	FALSE
adbcabdcbdada	FALSE
adbcacbcbacbb	FALSE
adddddbbdabdb	FALSE
adddddbdcacca	FALSE
baccabadabaca	FALSE
baccacbbcdcba	FALSE
bbbacdcbdbbcc	FALSE
bbbadbbbbabca	FALSE
bbddccccabacb	FALSE
bbddcddcbadab	FALSE
bccccbdcbcbab	FALSE
bcccccbadadcb	FALSE
bdbaccddbadcd	FALSE
bdbacdcdaadbc	FALSE
bddcccbdacacb	FALSE
bddccdddbdcab	FALSE
cacadbccbbbaa	FALSE
cacadbdacccba	FALSE
cbacabcacaacc	FALSE
cbacacbdcdcbc	FALSE
cbcddcddcbadb	FALSE
cbdaaaaddadab	FALSE
ccbbccdabdbdd	FALSE
ccbbcdbadddcb	FALSE
cdaacccaccbab	FALSE
cdaadbbaddacd	FALSE
cdcdcababdaab	FALSE
cdcdcabbaabdc	FALSE
dabacbbcdbaba	FALSE
dabacbcdcccdd	FALSE
dadcdbaddccdb	FALSE
dadcdbdbaabdb	FALSE
dbcacbcacabac	FALSE
dbcaccdcaccab	FALSE
dcacadcaddbdc	FALSE
dcacbbbcabaad	FALSE
dcdacabcabaaa	FALSE
dcdacbbccddab	FALSE
ddbdabccabdcd	FALSE
ddbdaddcdaacb	FALSE
aaaaaaacdacaad	TRUE
aaaaaacaddadac	TRUE
aaccccdccdaaad	TRUE
aaccccdcdaccca	TRUE
acaaaadaadcdcd	TRUE
acaaaadaccadca	TRUE
accccaddcdcada	TRUE
acccccadacaccd	TRUE
acddacdaaaaada	TRUE
acddadaaccadcd	TRUE
adcadacacddccc	TRUE
adcadaccccacdc	TRUE
adddcacccdaadc	TRUE
adddcacddcddda	TRUE
bacdadadaacddd	TRUE
bacdadadcacdad	TRUE
bbbaaacaadaccc	TRUE
bbbaaadacddaac	TRUE
bbdbdcdaacddda	TRUE
bbdbdddcbaddda	TRUE
bccaaccddacddc	TRUE
bccaacdacdcadc	TRUE
bdadacdcdddaca	TRUE
bdadadacacadca	TRUE
bddadcaaccdcaa	TRUE
bddadcdcdccaca	TRUE
caccacaacaaccc	TRUE
caccacccaacdca	TRUE
cbaadddacadcaa	TRUE
cbaaddddcdcaad	TRUE
cbcdcbddccdcbb	TRUE
cbcdcccbcaacca	TRUE
ccbbacccaddadd	TRUE
ccbbacdadadddd	TRUE
ccddadaddadacd	TRUE
ccddaddaaacccc	TRUE
cdcacddaaccccd	TRUE
cdcacddaaddcca	TRUE
daaccacaadcacd	TRUE
daaccacacdcccc	TRUE
dadcccadddcddc	TRUE
dadccccccdcada	TRUE
dbbdcccacccacc	TRUE
dbbddcaadaaddd	TRUE
dcacaacdcaaacc	TRUE
dcacacccddcacc	TRUE
dccdadadcaaacc	TRUE
dccdadadddcaca	TRUE
ddbcbbbcaadcad	TRUE
ddbcbccbaaaaaa	TRUE
aaaaaaadbbaacb	FALSE
aaaaaabadcccac	FALSE
aaccabdabbdccd	FALSE
aaccbabddcbcbc	FALSE
abbbbbdaccdadb	FALSE
abbbbdbdcacdca	FALSE
abdcdbbddadcbc	FALSE
abdcdccbacabdc	FALSE
accabddbbccadc	FALSE
accacabccbadac	FALSE
adbacaaacbbddd	FALSE
adbacbcccdbabd	FALSE
addcccdacaabba	FALSE
addcccddbbcdcb	FALSE
bacaddabbaadcb	FALSE
bacaddbbacbbdc	FALSE
bbadbaaccdaccd	FALSE
bbadbbccadacad	FALSE
bbdadaadbbacbc	FALSE
bbdadabadccddc	FALSE
bcbdcbacdddacb	FALSE
bcbddaadbdabaa	FALSE
bdacdcdadbacbc	FALSE
bdadaabdbddaca	FALSE
bddadbacbcdbad	FALSE
bddadbbbababcd	FALSE
cabcaacaadccbb	FALSE
cabcacbadcaadd	FALSE
cbaacbcbacabdd	FALSE
cbaaccbbaddcbc	FALSE
cbcccbcdadaacb	FALSE
cbccccacabaadc	FALSE
ccaddcaccadcba	FALSE
ccaddddadaaddb	FALSE
ccdccccacacbad	FALSE
ccdcccdccdbacb	FALSE
cdcacadaccbbbc	FALSE
cdcacbccabaaaa	FALSE
daacbbdddbddab	FALSE
daacbcbddadada	FALSE
dadaddbdbadcdb	FALSE
dadbaaacddcbcd	FALSE
dbbdacbbbbcbac	FALSE
dbbdacdabcabcd	FALSE
dcaacdcbabbaaa	FALSE
dcaacdcbddccdb	FALSE
dccbdddccaacab	FALSE
dcccabdbcbbdcd	FALSE
ddbaacccdccacb	FALSE
ddbaadbbcdacba	FALSE
aaaaaaaadcddccd	TRUE
aaaaaaadaddddac	TRUE
aaccaddddcdcdca	TRUE
aacccaacaccddca	TRUE
aadddadcaccdddc	TRUE
aadddadcccdaadc	TRUE
acccdadcaadadaa	TRUE
acccdadcaccacad	TRUE
acdddcaaddadaac	TRUE
acdddcaccadddac	TRUE
adcccccaadcdcca	TRUE
adccccccccccddc	TRUE
adddcddadccccdc	TRUE
adddcddcaaccadd	TRUE
bacdcaaacaaaadc	TRUE
bacdcaaddacaacc	TRUE
bbaddccccdcaddc	TRUE
bbaddcccdcddcac	TRUE
bbdadadaadcadaa	TRUE
bbdaddadcddacac	TRUE
bcbdacdadcadada	TRUE
bcbdadaadcacddd	TRUE
bdaaddadccadcdd	TRUE
bdaaddadddcdccd	TRUE
bdccdcdaddadacc	TRUE
bdcdaaadcacdaca	TRUE
caaddaaccaacdad	TRUE
caaddaadcaccacd	TRUE
caddacdacaaacaa	TRUE
caddacdccdaaadd	TRUE
cbcaadddddaaadc	TRUE
cbcacaaaaccddcd	TRUE
ccadacacadaccdd	TRUE
ccadacacccdcddd	TRUE
ccdbaadccddadcc	TRUE
ccdbacadcaccacc	TRUE
cdbdbbacdcdcaac	TRUE
cdbdbbdadddddcc	TRUE
daacacadddcacac	TRUE
daacaccdcdcdaac	TRUE
dadadddaaccccaa	TRUE
dadaddddcacccad	TRUE
dbbcdacaaaacdaa	TRUE
dbbcdadaaccacda	TRUE
dcaccaaaacccaac	TRUE
dcaccacaacdaaaa	TRUE
dcdaadcadcaddac	TRUE
dcdacaaacdaddcc	TRUE
ddbcbccaadaaadc	TRUE
ddbcbdaaaadaaca	TRUE
aaaaaadbababcad	FALSE
aaaaaccdaadabdb	FALSE
aaccbdaacadacbb	FALSE
aaccbdbcdacbdac	FALSE
abbbbcabcddadca	FALSE
abbbbcabdbddddd	FALSE
abddbdbbadbccab	FALSE
abddcaddaabdbcc	FALSE
accdbddaabddaab	FALSE
accdcaccbbbcacd	FALSE
adbbacbdacadacd	FALSE
adbbadabbbdbadb	FALSE
adddadabaccadcd	FALSE
adddadaddacaacb	FALSE
bacbdadbddccaad	FALSE
bacbdbadccacdac	FALSE
bbbadabadbcabbb	FALSE
bbbadabdbdbcddd	FALSE
bbdcbacbabccaab	FALSE
bbdcbadcabbadba	FALSE
bcbcccaddcdccdb	FALSE
bcbcdacaabdcdcd	FALSE
bdaadccbdaddbca	FALSE
bdaaddaabadcccd	FALSE
bdccdccddcbdbab	FALSE
bdccddbaccbadbd	FALSE
cabbbaabadccadc	FALSE
cabbbaccddcdbba	FALSE
cadcdcddbddbdab	FALSE
cadcddccbcbcbcc	FALSE
cbcaddabcccccda	FALSE
cbcadddcbbbcbba	FALSE
ccadaaaabbbbdad	FALSE
ccadadcabaaacda	FALSE
ccdadccdbaabbbb	FALSE
ccdadddccdaccab	FALSE
cdbddbbdbbcbdab	FALSE
cdbddbcabadcbbc	FALSE
daabbdaaddbcddd	FALSE
daabbdabccdacac	FALSE
dacdcbcddbdacda	FALSE
dacdcdbcdddcaba	FALSE
dbbbbadbbcdacab	FALSE
dbbbbaddcdcbcba	FALSE
dbddccdcccbdbab	FALSE
dbddcdbabddcdbb	FALSE
dccccabcbaabdaa	FALSE
dccccbbbaacacdb	FALSE
ddbbabbdddaacac	FALSE
ddbbacadadabdcc	FALSE
aaaaaaaadcddccda	TRUE
aaaaaaadddddacad	TRUE
aaccacadaccaddcd	TRUE
aaccaccacdaaaadc	TRUE
aadddadddacacdda	TRUE
aadddccddcccadad	TRUE
acccadcacdddcadc	TRUE
accccaaccaaadcdd	TRUE
acddddaccaaacada	TRUE
acddddaccdcddadc	TRUE
adccaadaacaaddac	TRUE
adccacaadccccaca	TRUE
adddcadcaddccdcc	TRUE
adddcadddddadccd	TRUE
bacdddcadadadacc	TRUE
bacdddcadcccacca	TRUE
bbbbadcddaacddca	TRUE
bbbbadddcacacaac	TRUE
bbddbccbbdaddada	TRUE
bbddbdccadcaadcd	TRUE
bccacdcdadaddaac	TRUE
bccadaacacddcdcd	TRUE
bdacccadcaadddcc	TRUE
bdaccccaacacdada	TRUE
bdccccaaadddacdc	TRUE
bdccccaccdcadcdc	TRUE
cacacdacdaaaacda	TRUE
cacacdadccaaaaad	TRUE
cbaadcaacaaaddca	TRUE
cbaadcadcacccaca	TRUE
cbccbdcddcddbddd	TRUE
cbcccadcddcacdad	TRUE
ccbacaadaacdcaaa	TRUE
ccbaccadacccaada	TRUE
ccdbbddacadaccdd	TRUE
ccdbcacccddcdadd	TRUE
cdbdbaadcacdaaaa	TRUE
cdbdbadacacdacac	TRUE
daaadddcccdacadc	TRUE
daacaaaaaaacaadc	TRUE
dadacaaaccaacdad	TRUE
dadacadccddcdadc	TRUE
dbbbcddacaadcadc	TRUE
dbbbcddbbcaadcad	TRUE
dcaaacccccdaadcc	TRUE
dcaaadcadaaaaccc	TRUE
dcccddbbbdcbbdbd	TRUE
dcccddbdadddacca	TRUE
ddbadddcacdccaaa	TRUE
ddbbaaacadadddac	TRUE
aaaaaadaacdbcbad	FALSE
aaaaaccaaabdcbcb	FALSE
aacdacdbbdbccdac	FALSE
aacdacdccccbccca	FALSE
abbbacdaadcbccda	FALSE
abbbadabdcadbddc	FALSE
abddacadcdcddadb	FALSE
abddaccbbabbbddc	FALSE
accabdabbcbbaaba	FALSE
accabdabdcabbdaa	FALSE
adacdadbccaadcba	FALSE
adacdadcacadcaab	FALSE
addbbbcadadbaaad	FALSE
addbcacaddcabcbb	FALSE
bacacbabbadbdbdd	FALSE
bacacbacdadacbad	FALSE
bbadbaadbcacacca	FALSE
bbadbacacabaaabb	FALSE
bbdcbbccabdcdcdd	FALSE
bbdcbcaccddcdbca	FALSE
bccacaddbbbaaabd	FALSE
bccacbdccbbdcdba	FALSE
bdabcddabdbaacdd	FALSE
bdabcddbdbaccccb	FALSE
bdcdbbdadbaabdcc	FALSE
bdcdbbdcdbacddba	FALSE
caaddcacadcabbac	FALSE
caaddcadddacbdcb	FALSE
cadcbbcbbcadacda	FALSE
cadcbbddbaabdddd	FALSE
cbcadcaacadacdcb	FALSE
cbcadcadbbbacdcb	FALSE
ccacccccaacbdcab	FALSE
ccaccdbbbddcccca	FALSE
ccdabaaaddacddbd	FALSE
ccdababaaabcbacd	FALSE
cdbcbbccdbdbdbab	FALSE
cdbcbbdbbccadbdd	FALSE
daaadbddbdbcacdd	FALSE
daaadcbdaaccdcdd	FALSE
dadaaccdbdbcadba	FALSE
dadaacdababcaccd	FALSE
dbbbdccaaadbcddb	FALSE
dbbbddcbcdcddadb	FALSE
dcabacdabadaddba	FALSE
dcabadabcddadccd	FALSE
dccdbcadacbbbdda	FALSE
dccdbcddbacadcbc	FALSE
ddbbddadcaababcd	FALSE
ddbbddbbccdccdab	FALSE
aaaaaaaaccadddadc	TRUE
aaaaaacdcaccddcad	TRUE
aacccccadacadacdc	TRUE
aaccccdaccdcdcaaa	TRUE
aadddacadaacdaccd	TRUE
aadddadadaadacaaa	TRUE
acccacadcdcaccdaa	TRUE
acccaccaadacddcac	TRUE
acddaddacaddaaaac	TRUE
acddaddcddcccdccd	TRUE
adcacacccdacaaadc	TRUE
adcacaccdaddddcaa	TRUE
addcdcaccadddcdad	TRUE
addcdcdccadcdddda	TRUE
bacccdcaaacccdcaa	TRUE
bacccdcddcdaaaacc	TRUE
bbacddcaadaacaaad	TRUE
bbacdddcddadcddcc	TRUE
bbcdcbcdccbbacaaa	TRUE
bbcddadaaadcaadac	TRUE
bcbbddaddcdddacad	TRUE
bcbbddcadccdadcad	TRUE
bcddcdadccaadaaca	TRUE
bcddcddbcaaaaadad	TRUE
bdccdbbacdddddaad	TRUE
bdccdcdaaccaadccc	TRUE
caaddcccdacacccdc	TRUE
caaddccddadcaadcd	TRUE
caddacdddacadadac	TRUE
caddadacccddaacdd	TRUE
cbbdbcbadddaacacc	TRUE
cbbdbcbcbbcddcbcd	TRUE
ccadaaadddcaccdcd	TRUE
ccadaacdacdcddcda	TRUE
cccddbdadcaaacdad	TRUE
cccddbdbddcdbdbdb	TRUE
cdbcaccdcaaddcdcd	TRUE
cdbcaddccadccadcc	TRUE
daaadcaccddccddaa	TRUE
daaadcadddccdadcc	TRUE
dadacaddaddcccdca	TRUE
dadaccccccccaaadc	TRUE
dbbcccdbdadccaadd	TRUE
dbbccddcacdcaacaa	TRUE
dcaadccdacadadccc	TRUE
dcaadcddcccccaadc	TRUE
dccdcccbadacdcada	TRUE
dccddaacaaddddadc	TRUE
ddbcaccccdadaaadc	TRUE
ddbcaccddcddcdadd	TRUE
aaaaaaabadcacaacc	FALSE
aaaaaabadacbddabb	FALSE
aacbaccabbacbcbdc	FALSE
aacbadaccddaaaabd	FALSE
abbacccbdaabddbbd	FALSE
abbaccdbadbbcdbca	FALSE
abddadabbdaaaaaad	FALSE
abddadbbadbcdccdd	FALSE
accbcbbcdbbbaccdd	FALSE
accbcbcacacabddac	FALSE
adacdbbdbbbcbcaac	FALSE
adacdbddcbcdbddca	FALSE
addaddbbbcacbbccc	FALSE
addaddcccddbaacdc	FALSE
babdbbdbcaddacbbc	FALSE
babdbcddbaadaccaa	FALSE
bbaaddacdcaadcbcd	FALSE
bbabaaadbadbbddbb	FALSE
bbcddcaadbbccbdaa	FALSE
bbcddccdcacdacbad	FALSE
bcbbdaababcadbdcb	FALSE
bcbbdaabbadacacad	FALSE
bdaabadaadddbacdc	FALSE
bdaabbaccbadabccb	FALSE
bdccbadaaaaaaacdb	FALSE
bdccbbdddcbbaaccb	FALSE
cabaaabadcdcdaaaa	FALSE
cabaaacbddbcdccbc	FALSE
cadcdddadcddcbdcc	FALSE
caddabcacbdaadabb	FALSE
cbccbadbaababaabb	FALSE
cbccbaddadddcdbbd	FALSE
ccbabdcabbcadaadc	FALSE
ccbabdcabcbaddbba	FALSE
ccddbacccadaccacb	FALSE
ccddbbdaadbddaadd	FALSE
cdcbcbdcbbbbbcdab	FALSE
cdcbccaadcbdabdda	FALSE
daadcacbabadaaaca	FALSE
daaddccddbcdacabd	FALSE
dadbbbadabaacbaac	FALSE
dadbbbccccbcdaabb	FALSE
dbbdabdccdbcccaaa	FALSE
dbbdaccbcacbdccdc	FALSE
dcabcbdaaddbacbbd	FALSE
dcabcbddcadcbdddc	FALSE
dccdddbdcbabbabbb	FALSE
dccdddccbbaaaabbb	FALSE
ddbcdbacdcdcaabbc	FALSE
ddbcdcccbbdabcdda	FALSE
aaaaaaacdddcdcadad	TRUE
aaaaaadaccccccdadd	TRUE
aaccacdccacdddcddd	TRUE
aaccacdccdcdccdcad	TRUE
aaddcccacaaacaccdc	TRUE
aaddccccdcaacaaccc	TRUE
accacadaacaaacdcca	TRUE
accacccacaddddaaaa	TRUE
acdcddcaacdaadaacc	TRUE
acdcddccaaadaaaacc	TRUE
adcaacaaddddccddcd	TRUE
adcaacacacaacdcdaa	TRUE
addcccdaacaddccdcd	TRUE
addccdaaadadaddcdd	TRUE
baccacdaccddcaadcd	TRUE
baccacdddcdadddada	TRUE
bbacdcacdccaacaacd	TRUE
bbacddaaccadadacaa	TRUE
bbdaacdaacddcadadd	TRUE
bbdaadadacdaddcddd	TRUE
bcbcbbbddaddaddcdc	TRUE
bcbcbcadcaaaaadcca	TRUE
bdaaadcaddacddccad	TRUE
bdaacaddcddcadcadc	TRUE
bdcbcdccdaccdccdac	TRUE
bdcbdacacadcddcdcd	TRUE
caadccdaaadcacccad	TRUE
caadccddccdadccaaa	TRUE
cadddcddadaddacadd	TRUE
caddddacadcaacddad	TRUE
cbcbccdacaacddcdca	TRUE
cbcbcdaacadaccdaad	TRUE
ccadcdadaadcddddcd	TRUE
ccadcdccdcccccdddc	TRUE
ccdcadadaaacaaacca	TRUE
ccdcadcaadaccdcdda	TRUE
cdcbcaadccdccdaddd	TRUE
cdcbcbdaacdcaadcdd	TRUE
daadaddaccaaddaccc	TRUE
daadcacccadaddcada	TRUE
dadcdadaccadcdddad	TRUE
dadcdadcaaacadddca	TRUE
dbbdbbbbdaaccacdcc	TRUE
dbbdbcadcccdadaadd	TRUE
dcacdcdaadddadcddc	TRUE
dcacddadcdcdaccada	TRUE
dcdbbddacccaadaaac	TRUE
dcdbcaaadcacdddddc	TRUE
ddbcdaddcdaaaaaacd	TRUE
ddbcdbadccccadccad	TRUE
aaaaaacccdbacbdadb	FALSE
aaaaabaacccaadbccb	FALSE
aaccaccadcbdccbcab	FALSE
aaccbaadcbdadcaabd	FALSE
abbabcdbaaddcbacdc	FALSE
abbacaccdcaababdcd	FALSE
abdcdbbddbadbaabbb	FALSE
abdcdbcaadccbdbbcc	FALSE
accbbccbcccbbdaabc	FALSE
accbbddbcbaabadacd	FALSE
adadbabcdccdbcdcbc	FALSE
adadbbccdbabcccabc	FALSE
addbcccdcbbaababcb	FALSE
addbcccdcbbcdcddad	FALSE
babdcccccddddddbaa	FALSE
babdccccdaacabdaac	FALSE
bbacbcdddbbdbcacca	FALSE
bbacbddddaabacdadd	FALSE
bbdabdbdaddbacdadc	FALSE
bbdacaabaadcadbcdd	FALSE
bcbcbbbcacadbbbdba	FALSE
bcbcbcbadabaddbbad	FALSE
bdabcdbbabcaaacdac	FALSE
bdabcddadcaccddabc	FALSE
bdcccccadadbdccccb	FALSE
bdcccccdcddbbccadb	FALSE
cabbabbccdbccddddd	FALSE
cabbabccbcaaabbaab	FALSE
cadddadccaddbdcaaa	FALSE
caddddbccbcddcbccb	FALSE
cbcccaddcbbdddbbcc	FALSE
cbcccbaaccbbbcdbab	FALSE
ccbbadbbabdbccbdba	FALSE
ccbbbaabaacadbadab	FALSE
cdaaabbbbbcaddcbbb	FALSE
cdaaabcdcbaccaccba	FALSE
cdcbdbbdaddaddbcbd	FALSE
cdcbdbccaddacdbdba	FALSE
dabbaccdbbdcabbdcd	FALSE
dabbadabbcacabcbda	FALSE
daddbddbbbaacbccdc	FALSE
daddcabbaadadbbbdc	FALSE
dbccabdcbaadcccbaa	FALSE
dbccacaccadbbccadb	FALSE
dcadaddabadacacaac	FALSE
dcadbaccbbacbccacd	FALSE
dcdabaddbdbcabddca	FALSE
dcdabbbdbdaadcadbc	FALSE
ddbbcddbaadbaadbcb	FALSE
ddbbdabbdbdbacbcdc	FALSE
aaaaaaaaddcaccadcda	TRUE
aaaaaaadccddcdddcac	TRUE
aaccaccaaacdcccdddd	TRUE
aaccacdcacdaadddcac	TRUE
aaddcdcccccaadddaaa	TRUE
aaddcdccddddaddcdcd	TRUE
accaddddacaadaadccc	TRUE
accaddddacdacccadad	TRUE
acddcaaadacacaadacc	TRUE
acddcacaccccdccdccd	TRUE
adadddcdaacddcaaadd	TRUE
adadddcdaadaaddddca	TRUE
addccadddacadaccadd	TRUE
addcccaacdddddacaad	TRUE
baccacccaadadcdcccd	TRUE
baccacccadccccddcdc	TRUE
bbaaddaccaadaacdacd	TRUE
bbaaddacccdccacdaca	TRUE
bbcdcccdcdbaaccdaad	TRUE
bbcdcdadadccacaccdc	TRUE
bcbbcacdaccaccdcaac	TRUE
bcbbcbbdadacccdcdca	TRUE
bcddcbaacaadcdaddac	TRUE
bcddccbcaccacaaacda	TRUE
bdccccdcaaaacdaccda	TRUE
bdcccdcbdadccaddadc	TRUE
cacaadcdcdcacaacacc	TRUE
cacaadcddacccacadad	TRUE
cbaaadddccdccccaccd	TRUE
cbaacaadccddcdcccad	TRUE
cbccbddaadcdcaadcdd	TRUE
cbccbddacdddcacaaad	TRUE
ccbaaaadddddccccdad	TRUE
ccbaaaccaddcccdccac	TRUE
ccdddbbdadadcdadacc	TRUE
ccdddcccdcdcccbbbbb	TRUE
cdccadccccddaccaaac	TRUE
cdccadcdcdcdcddaaac	TRUE
daadccdadacdacacddd	TRUE
daadccdcdaadcdcacac	TRUE
dadcdcaaaddacaacdac	TRUE
dadcdcadddaacdaacdd	TRUE
dbbdbbddaaacdcdcddd	TRUE
dbbdbcccaaacdcaacad	TRUE
dcaacdadaaddddcdddd	TRUE
dcaacdcadaacccdddad	TRUE
dcccbdacdaacadadacd	TRUE
dcccbdbdbdbbbaadcca	TRUE
ddbacdccdadaaadaaad	TRUE
ddbadacdddddacaacaa	TRUE
aaaaaabbbcddcdbdbdc	FALSE
aaaaacabbaabcadbadd	FALSE
aacbdaddccdacbbcadc	FALSE
aacbdcabdcabbdcdbdc	FALSE
abbaaaaccbdbbccaccc	FALSE
abbaaacccbcadaaaccb	FALSE
abdcbdcbdccccbccdaa	FALSE
abdccacdcdaadccaddb	FALSE
acbdabcbabdcabbaaaa	FALSE
acbdabcbcccbddbbdbd	FALSE
adaaccbcdbdbaadadbc	FALSE
adaacdbdcdacbbbabaa	FALSE
adcccacbcbcabdbccac	FALSE
adcccaccaaccbadcaba	FALSE
babbccacbccccdccbdc	FALSE
babbccbcadaccacaaac	FALSE
baddcdbdbdcbdadbaac	FALSE
badddccacddccdabbcd	FALSE
bbcabdcdadaccdbddab	FALSE
bbcacabadbbbbdcdcab	FALSE
bcbbcabccaaddcadcbb	FALSE
bcbbcacacdaaddaccdb	FALSE
bdabcdcbcabdaddcbad	FALSE
bdabdaabababacdaaaa	FALSE
bddaabbadabbdcbcadb	FALSE
bddaabcaccbbadadcbd	FALSE
cabdbbbbbbbbcacbdbd	FALSE
cabdbbcbadadcdbcccb	FALSE
cbabdbdbdcbbcacdccb	FALSE
cbabddadabaacddcbad	FALSE
cbdabadbcbcbccdcbba	FALSE
cbdabbddaaaaddbcadb	FALSE
ccbdbdbadbadbdadacd	FALSE
ccbdbdbcabbadcccdcb	FALSE
cdabaddbaabcddccbab	FALSE
cdabbacabbbdbddadad	FALSE
cdcdadbcddbaccddcab	FALSE
cdcdbacdddaaccaabdd	FALSE
dabbacbaaccdccbcaba	FALSE
dabbaccddaadadabbcc	FALSE
daddbbbccbcbdcacada	FALSE
daddbbbcdbdcaabbacc	FALSE
dbcbcacabbbbcdbdbda	FALSE
dbcbcaccadcbbbabbda	FALSE
dcacdbabdcaddcaadca	FALSE
dcacdbabdccabbbcacb	FALSE
dcdadbdabcbacbabbbb	FALSE
dcdadccadadabdbcdca	FALSE
ddbcabaacacdddbdada	FALSE
ddbcacabacdcadccbab	FALSE
