AAAdWYHsWI	TRUE
AAUacozick	TRUE
CAfAccxWJa	TRUE
CAuCimstIk	TRUE
EEudQfkdMV	TRUE
EFCzklUxZb	TRUE
GHDniwTDJf	TRUE
GHFGoBSRhk	TRUE
IGUOSneJoE	TRUE
IGaVXoKFft	TRUE
KPhDZjKnFg	TRUE
KPpuURTJYs	TRUE
MZYsNDXSgC	TRUE
MZuwEVuaBA	TRUE
OWFxrKRVtQ	TRUE
OWJAzBHJWW	TRUE
QXhtUoHliC	TRUE
QYescluXnm	TRUE
SQOxdemmSr	TRUE
SQVWSDOejR	TRUE
UTtODJYLBi	TRUE
UULvNWmMah	TRUE
WPBEXGACRL	TRUE
WPiUjXHPNg	TRUE
YLWKWnmzvt	TRUE
YLWSMMZZxE	TRUE
aOrmiBdoMx	TRUE
aOtEbMourN	TRUE
cUrWxEuwCP	TRUE
cUtfnqivIO	TRUE
einhECuSoa	TRUE
ejBnIASwNj	TRUE
goGSuDaHQk	TRUE
goUIWIXKOd	TRUE
ihzXraRtnn	TRUE
iigaxJQgmR	TRUE
kltxIDDFcq	TRUE
kmSdFIbgiX	TRUE
muvXfbusGf	TRUE
mvDBrTvHQJ	TRUE
pQMUoErWmC	TRUE
pQXqcovDdl	TRUE
rPeNjcEJhE	TRUE
rQDYAxjmew	TRUE
tWefxxeWXn	TRUE
tYJyrqmaqd	TRUE
vdbpvWBYYL	TRUE
veiCkMYjTy	TRUE
xvOtbhWlWg	TRUE
xwteXJrvtK	TRUE
ABgBgòdhoF	FALSE
ABóTeoHWàb	FALSE
CnnúóǔéEék	FALSE
CnrmWvwmgó	FALSE
FKPCRwpòtp	FALSE
FKfEàMěuuG	FALSE
HǎIcmLCURk	FALSE
HǎxBEYZǒǒk	FALSE
KepYFpCàǔp	FALSE
KflóyVihHi	FALSE
MěàAtkVDGá	FALSE
MǒxèMùjGXK	FALSE
PktcDědáúX	FALSE
PkǎJOzUSáD	FALSE
SGPNàèqAqo	FALSE
SGbèKYQnyt	FALSE
UqMòARGZIx	FALSE
UqyúélJxZs	FALSE
XSnIPOJlěL	FALSE
XSyxiVCVkǎ	FALSE
ZúDaèfBqBd	FALSE
ZúlaháZǔxt	FALSE
cRlxuCJáéo	FALSE
cSJòuǎáújG	FALSE
euRffeubyù	FALSE
ewPPjàqeyV	FALSE
hQVéaOXOhx	FALSE
hQxweETuHě	FALSE
jǒèLZjKákV	FALSE
jǔAklMyólc	FALSE
mgKjLyoszó	FALSE
mgdGěgCSkG	FALSE
oǒúdnyǔqZp	FALSE
oǔKyUoòèúù	FALSE
raoKqJmCaě	FALSE
rawdzDòcUA	FALSE
uBLnElqIoá	FALSE
uBmóǒVryDk	FALSE
woqóǒZjkQx	FALSE
wpfNnpGWáú	FALSE
yàěKTYUWCó	FALSE
yèùǔBéDònR	FALSE
ávyCBFhmQh	FALSE
áyPgáZúlěs	FALSE
òiLzLùXxFP	FALSE
òkuAqGBgFy	FALSE
ùǒFLEKqdúh	FALSE
ùǔdfáAmPrn	FALSE
ǎoáWOpzSéT	FALSE
ǎqBxuzTRód	FALSE
AAIaJMVrORf	TRUE
AAeqpddMRjF	TRUE
CHvXdufiWGO	TRUE
CHyRdgIAvAX	TRUE
EETXIQNUhJt	TRUE
EEdXxUPsYkg	TRUE
GHQyHbhHSCh	TRUE
GHflmnSHWWf	TRUE
IFpQOgGzyjt	TRUE
IGPtgzIyZnn	TRUE
KIaEcoPODSj	TRUE
KIwyysWPbjp	TRUE
MMEQbniJQLs	TRUE
MMFAAxvyBms	TRUE
ONyHeetqePF	TRUE
OOQjMDvxctR	TRUE
QFpwtPcuqiZ	TRUE
QFqERxXhnte	TRUE
RzTbhKVcmWA	TRUE
SACCSHSeoXg	TRUE
ULbmgxwZCKS	TRUE
ULeDnVdQCeg	TRUE
WPGpiPAPSrl	TRUE
WPJIHWWHWQp	TRUE
YRcNOIZulUv	TRUE
YSBcNToPgoa	TRUE
aZJiwEZXtMF	TRUE
aZZxbffbNoX	TRUE
ctvnFRdlWCq	TRUE
cuDzYNvijKO	TRUE
fKmIuSwgAPG	TRUE
fKpZFbQHNkh	TRUE
heIntcAfpVr	TRUE
hePDvbPhYed	TRUE
jpnUslGKEuQ	TRUE
jppwtApQvhA	TRUE
llRkXpDrCBU	TRUE
llbOSfYsZka	TRUE
nsUhnNdkwUp	TRUE
nsYVnBTinBy	TRUE
qAbDEUENlSN	TRUE
qCLXWYClyzj	TRUE
ryWQGDFSRti	TRUE
ryeajKjWehQ	TRUE
tyvJFXULmHD	TRUE
tzBBKAApiAr	TRUE
vutxjJgLKjA	TRUE
vuwDoLhxeJI	TRUE
xrQvIUBvdMM	TRUE
xsXPfuLTbbK	TRUE
AADxǔFǔéǎòu	FALSE
AAINkúòlnhR	FALSE
CoSWFvLxcbǒ	FALSE
CroxOéǎFrPK	FALSE
FGqǎZdkcEǒS	FALSE
FGtgIESkJrú	FALSE
HiájcópFJPZ	FALSE
HjKDrjFrZQě	FALSE
KCWpWǎqRDFa	FALSE
KCgpAtoùáIB	FALSE
MnZǔMUdùfJò	FALSE
MněǎSGaéOvF	FALSE
PLpiUólcrHK	FALSE
PMYáEKùěhYá	FALSE
RNxCàràtNTè	FALSE
ROKqQNIòddò	FALSE
TǒJtSTMòGjě	FALSE
TǔDLdwyEàMY	FALSE
WiǎǒJqUcntB	FALSE
WjapUwMlvEè	FALSE
ZHDǔqMnúknM	FALSE
ZHSùuóQfzzW	FALSE
buSJeǔplxFd	FALSE
buéòvyNáùUg	FALSE
epóǒCwzrDxR	FALSE
erZfsiězsǎu	FALSE
hgNEyevlHQù	FALSE
hgwRàVáIMěǔ	FALSE
kPRlnOrNwǎE	FALSE
kPWBBzEàvzK	FALSE
mrHǎhcùàljM	FALSE
mrMiémKǎubH	FALSE
pEIjPjegǒie	FALSE
pEjùmkidǔóV	FALSE
rpǎùùcAJxuH	FALSE
rqPCnjqpdàc	FALSE
uJLámHbxozK	FALSE
uKFifcBGxdú	FALSE
wcgǔZFbQHNě	FALSE
wchkhkQáǎNU	FALSE
zGEGǔffiǔAj	FALSE
zGVSǔPaOzUe	FALSE
áhZùáàipVft	FALSE
áiOHGVùyòse	FALSE
òHOnkrtǎYNP	FALSE
òJkfypkxǔjH	FALSE
ùixcMǒyArúm	FALSE
ùjBDBdXCvCl	FALSE
ǎPùmHGgJVwǎ	FALSE
ǎQfkwEiIuix	FALSE
AAKNrbUwDqXf	TRUE
AAMmSQphChne	TRUE
CFknOFvWhQqV	TRUE
CGGmBSNhUeXm	TRUE
EKgJAZizGhdB	TRUE
ELQYeTyrkkUB	TRUE
GNMRYnmiayxd	TRUE
GNZBTElAfCRi	TRUE
IfGjHpangFgc	TRUE
IftBDPsInrNy	TRUE
KufNzWqCbUWK	TRUE
KulkOCKQMAxo	TRUE
MnHrpZfdOVXz	TRUE
MnhKimXXqkhZ	TRUE
OklbgOnLefiF	TRUE
OkyYSzTGAYsx	TRUE
QwmMQaljQTgJ	TRUE
QxqQQffqOKnf	TRUE
SzOFfEBiiTbt	TRUE
SzPAvSkuyZog	TRUE
VIrGmrWFESPD	TRUE
VIxlUJEMKuDa	TRUE
XXgxDXcdGgqT	TRUE
XXnvtoINyqVi	TRUE
ZTzlPYGhgTUI	TRUE
ZUOTDDolpzXD	TRUE
bbPVqnBfiLtP	TRUE
bbbTfYvAASMr	TRUE
dbOHtbhukcXk	TRUE
dcItpolIXPKt	TRUE
fREnmYvmbZLz	TRUE
fSWOLLCsgKJa	TRUE
hTWncnyOKarp	TRUE
hTewTthynFzW	TRUE
jRtAMzmzfEZa	TRUE
jSGByWQtOXFD	TRUE
lVuYgeaOKrsi	TRUE
lVwFJifUGPNA	TRUE
nhGgfXivguqo	TRUE
nhnktYerloFw	TRUE
pmzQZmdwQucI	TRUE
pndorHIucEzZ	TRUE
rvRxGlYJBgrJ	TRUE
rxaCPwQNSJtY	TRUE
tuwfUzmVBtTP	TRUE
tvugfUVdEWby	TRUE
vxHoWghCObJg	TRUE
vxIFLTSwxYPl	TRUE
xwgDqjiUmxID	TRUE
xwhfauhHgrVn	TRUE
AAǒeZcáěOuǔh	FALSE
ABaècèshèuQo	FALSE
CbhXKAjcnFLǎ	FALSE
CcgúúURzHLkà	FALSE
EèbnmùEROěcT	FALSE
EéFùDúavqZPf	FALSE
HbcdAfndowàQ	FALSE
HdSKTièOqeéC	FALSE
KBEúHXgsòBLè	FALSE
KBééàJpfzopO	FALSE
MdúvUaSheTǔZ	FALSE
MfLXyGXVgEzó	FALSE
OùLBLHOPéaiH	FALSE
OěKúvSpǔOóǒF	FALSE
RkUùDRYàkèJx	FALSE
RlEjHVHjGvéK	FALSE
UQeáǎusǒáNjY	FALSE
USYiyBIbTFXè	FALSE
WùpDéxYQtYvǒ	FALSE
WùugkFdkeqǔS	FALSE
ZUméáqhhbZěA	FALSE
ZVámCHùaOgòR	FALSE
báOOWdǒòRPMU	FALSE
báQwmúlPMgdG	FALSE
ejmtGonfKFLǔ	FALSE
ejàhYéIrOfdé	FALSE
hdáěǒlkǒhùqq	FALSE
heDdRèUzyeNF	FALSE
kJeávzexHèjb	FALSE
kLGòeáWtTQQq	FALSE
mywGǎJǎhàeQc	FALSE
màUPUàsàǎCFm	FALSE
pFNlǒBURQuAU	FALSE
pFcòwwbTifsl	FALSE
réWjZgWMqUHě	FALSE
rérèǎctiYkúg	FALSE
uGLwúGcrRydr	FALSE
uGùiQzAàkwHW	FALSE
wpGepGxBsCIò	FALSE
wpùúnèiowhCe	FALSE
zSRǔyxWCmǔKs	FALSE
zSizLěMwrddù	FALSE
èAjqYORxcVbv	FALSE
èAkCòMJnhFKK	FALSE
ònQooǎméHmǒP	FALSE
òqSaGbjnkóGK	FALSE
úLoěZzlóěQJǔ	FALSE
úLáěZoHpcLba	FALSE
ǎhFbDxUIVCcl	FALSE
ǎhMQùxoZvpbg	FALSE
ABxadAZHyBpvh	TRUE
AByhKeVHDUeCt	TRUE
CIbITBlmypPrt	TRUE
CIdbyIXoBiriV	TRUE
DrRWrolIQTMym	TRUE
DrmbVEYONMqTs	TRUE
GCPnyVbAcRijD	TRUE
GCXTxatQuCnUA	TRUE
IBYgLiZYTrWoz	TRUE
IBvnNlEyYLMQg	TRUE
KJtPJACWakFGH	TRUE
KKHVUaihmgxzX	TRUE
LxXtwsAsPAAYJ	TRUE
LxeFHMZDaXtgT	TRUE
NzgywUqnVSMAp	TRUE
OASeKTiMXQGsG	TRUE
QSQFsQAsyLrMm	TRUE
QSfKwwcmYVPEK	TRUE
SagZakAhpfNrp	TRUE
SbFqEBkyMViEM	TRUE
UakniPuPpnjUf	TRUE
UbNYTnsrodflC	TRUE
WUZSUKnEITYbj	TRUE
WUktYOFokWhDr	TRUE
YPEfYAuqCRIvT	TRUE
YQsljJcXKMVUH	TRUE
acgjkUOmcAhEq	TRUE
adcCDBhSrWfrB	TRUE
ckRFMyYjqobnk	TRUE
ckwNYYYZNqMZt	TRUE
emJyWZdmxFBSj	TRUE
emXMnWxmcnKdT	TRUE
glwJczDKkEmDn	TRUE
gmoZdUPUcQZdj	TRUE
iyNXafhMOJPco	TRUE
izSqExcEkQnTz	TRUE
kwDuMNWfaEVMz	TRUE
kwOhfXcYLfVUq	TRUE
nHnrMzGzmEzxq	TRUE
nIIGGOrzmUDYC	TRUE
pHRGSnmRAMMWS	TRUE
pHVTPQuRjlLny	TRUE
rJwhDFNhRejHz	TRUE
rJzZnpctJyZCD	TRUE
tYZMTRtdmtNhh	TRUE
tYprmpwidcJYh	TRUE
vRrVDiCqNCJVx	TRUE
vTjETjhpDcZSz	TRUE
xnfhMzLJyfwmg	TRUE
xnorcgqSUYAgN	TRUE
AArYǔeiǒǎTtwV	FALSE
ABxTOIwCaǔzVM	FALSE
ChVJNoEbnbCHù	FALSE
CivFúSaHUBajp	FALSE
FDLTqdErVfgRè	FALSE
FEHdyǒSLOmFyU	FALSE
HaYYǒóCafSlev	FALSE
HbAǔóéJdEMtaF	FALSE
KHeéóPHBǒǎAkC	FALSE
KHùKTWtqóbáZǎ	FALSE
MùcyètgVvdZVW	FALSE
MùhàHěǔiHUQcà	FALSE
PVnhpóuéAáóCd	FALSE
PVoGGxQěGdóBt	FALSE
RǔDǎfdòuWgoYé	FALSE
RǔOwONéàéǎeBV	FALSE
UǔòTQòǎrPqěhA	FALSE
VBGwXNDqpbǎOR	FALSE
XgxJVòcéǔYlYL	FALSE
XgúVAXXóQsnDJ	FALSE
aFwmòóghiLděS	FALSE
aGNqwBàkPàbON	FALSE
cuQáuUéPútbFK	FALSE
cukUgòHHkzpkI	FALSE
fJwxWófsrEúiQ	FALSE
fMKàzáTkvBráY	FALSE
hxJOAArcdtùWl	FALSE
hxTúnKEcégveě	FALSE
kXuOGRpàSPBàE	FALSE
kXzTFwǒqwIsTò	FALSE
móàěuúyQYuiWT	FALSE
mùeùePhiKOòTo	FALSE
pfPxnWcWcfRWé	FALSE
pgElhNgHèbqàU	FALSE
ròUjǎTBSzYǎǎr	FALSE
ròXEnǔEéPPàdx	FALSE
uZǎǔfSUdèRVxǒ	FALSE
uaKoǒPSXGbGif	FALSE
xDVbBǔbqnNNsù	FALSE
xGLAXǎthmiuUo	FALSE
zkcwzdZGěvTzG	FALSE
zlLYluTvXOdqǒ	FALSE
áécJkwOjxYpOǔ	FALSE
áérEèkwjdctdM	FALSE
òhHhTAòhIAaIà	FALSE
òhRuAVòPlěOóC	FALSE
úKqdnAOàlYAem	FALSE
úMJRMktóóXrIG	FALSE
ǎtMnqHǔkěwJáǔ	FALSE
ǎtǔMǒùmkJcLJw	FALSE
AAMRmGCfMDampE	TRUE
AAbvtKLaLPYjPA	TRUE
BzVxuQYDkCaGXk	TRUE
BzlFJaleEiEUTy	TRUE
EIGdLGQTggUtfy	TRUE
EJTkyBNLamBVCU	TRUE
GRZxvAvZTLrSob	TRUE
GRfwhZCqKLFrOk	TRUE
IOukMNuKkxLWAI	TRUE
IPEiHcbmuTXVoi	TRUE
KfpUnKrVfItDWx	TRUE
KgQjAuehdOmGow	TRUE
MjjWvEtBJsGJJz	TRUE
MkKTCWqjFFczIP	TRUE
OkoxADEhquAKFs	TRUE
OkpipuVHVcyvYE	TRUE
QwASOtbkgMaJTa	TRUE
QwCShbdbLgOsFD	TRUE
TCOwuSlUtFWudq	TRUE
TCtjpwvuDGOnLN	TRUE
VFsAHxgUDOywpl	TRUE
VGhmqeOQvIEfih	TRUE
WyqtDNhGgAnwxw	TRUE
XAShfojqqTQUnq	TRUE
ZHSUsjAEipFJTe	TRUE
ZHeRZRwFlOSYYF	TRUE
bLDcOqblnvNQil	TRUE
bLVYFKKjZTjXUB	TRUE
dVMrkqkaOvKuZg	TRUE
dVrUfuuuimFdrD	TRUE
fYigjmCnShFrIP	TRUE
fYxUkSyyVfiEmV	TRUE
hPbJqTqIPoMfqd	TRUE
hPnURUolXqLLac	TRUE
jTElRbnQnUFpis	TRUE
jTzfVjvfIrEzfw	TRUE
lISfkzNbRrFyyU	TRUE
lKtnSFlqwTglzW	TRUE
nQOESttGVxcXfi	TRUE
nQUjAUYFpsRDOn	TRUE
pSgvddpJNZsUBs	TRUE
pSvAImNgctyNTf	TRUE
rXbyclhbPgXxWd	TRUE
rYkuNIngwHClVA	TRUE
tgadfJjZofjtwJ	TRUE
tipQCsACvTCKSi	TRUE
vwrqKNdwtyekFN	TRUE
vxPcyIyNxapkcM	TRUE
xugDCftNNaDEtG	TRUE
xvAZJhwrpcecSj	TRUE
AAScJidóiUzULQ	FALSE
AAzVwzkěFjǔécE	FALSE
CěRgtwzAPLsKBa	FALSE
CǎnvzITùPwgàac	FALSE
FrnùbàdgrRlǔdI	FALSE
FuIQxRuòEěRAGr	FALSE
ILOuváǔùQàNqBx	FALSE
ILVéxZiyJevHjò	FALSE
KoWNpǔqǒǔkXTin	FALSE
KodhǎhéWúLWkQU	FALSE
NapfFQǎrcělEmu	FALSE
NbOIdaZybWhTóò	FALSE
QPGhDDFàGYSexD	FALSE
QPKiǒlOrWUjhjà	FALSE
TJUkóWgyQSLéVz	FALSE
TKXPnLYLáǒoahR	FALSE
VsoěcésQRECùuù	FALSE
VtgUérULúWVBWg	FALSE
XófsMulmǔFXAàv	FALSE
XótóóyUkkzWlGě	FALSE
aLfhZEbRxǔyòáV	FALSE
aNnsFsàězkJnzw	FALSE
ciVICáèZXěxpQá	FALSE
cirobKàQbxvmTt	FALSE
fWqCgRQàMUHwcR	FALSE
fXDYúlEàIrRTXu	FALSE
húaGbXZjARbjCY	FALSE
húòueUBgǒqUCSI	FALSE
kiywQqYàǒgHǒFH	FALSE
kkSnPQjeàEóǎyT	FALSE
mánZǒèBZhgkNfú	FALSE
mátuhPwLèVJuXX	FALSE
pCùuǒnVǔRéGMjj	FALSE
pEHsZDCòzGeúsU	FALSE
rXbSxZrLxXYOXà	FALSE
rYénfóYfùilXDF	FALSE
uABrèmkzGZPaNú	FALSE
uAnSèYKuDjglsú	FALSE
wkFDkGGǎQùòěmǎ	FALSE
wkQGDcEQkVdydù	FALSE
zNOjCòKbgGzZzq	FALSE
zNTěyADòyEYrfS	FALSE
ásykbYDRJfixoi	FALSE
átEPjMùùXzáàae	FALSE
òTLNnásnEěrjxz	FALSE
òTòayúyCSEXSlǔ	FALSE
ùwéUgPIbXlqUDr	FALSE
ùxhAPùvàlvOpSJ	FALSE
ǎcàHNWvwFòweYk	FALSE
ǎdEYNyAMNoBòQq	FALSE
AABfhVPrWERMscC	TRUE
AAMIevTKmSTMWBm	TRUE
BuNCyDNkyEbsVmO	TRUE
BueWnqkjMAkZnRx	TRUE
DwgFnBgWBlfLuvJ	TRUE
DxvnGnNTRfDTVoA	TRUE
FriRTNjvcxNfKwT	TRUE
FrsxbRMbtEqnjVh	TRUE
HyirjDCcjmGfaKn	TRUE
HymhhyYXscYTyKl	TRUE
KHkUOrfmSjCnpjK	TRUE
KIepNRpdyjEGzSq	TRUE
MHPdgGwFAXecQSl	TRUE
MIyyAIHCoRDPxhA	TRUE
OMysQAKnzIjUEpa	TRUE
ONEoCNxeSiNutxJ	TRUE
QZrPLHgLwssLzRu	TRUE
QbLuaQyYgYKvBiu	TRUE
SmrEryRRYRCiAKy	TRUE
SmuRDSWjYOoGxPI	TRUE
UquvAOUBDBjCNrS	TRUE
UspyLGtakBzagzL	TRUE
WdBtxkcAOQHYIjp	TRUE
WdNMroPOdGtoQIV	TRUE
YXwEskGuhINeheL	TRUE
YYfsQMBEWyMvnjI	TRUE
albeaEPwrLGjhRQ	TRUE
ambiLytXnyHighb	TRUE
cpjuwNPFgJwTvtC	TRUE
crBqubjjcHWeTza	TRUE
eymyzDscZzJRJBh	TRUE
ezFIKFMFLDJrSOa	TRUE
hAkAXKfyHKCFAEp	TRUE
hBYLyAIuSEHSIgA	TRUE
jDsgSMDFilFLbdc	TRUE
jEWvIYOETivDoBm	TRUE
lIgWAMqEQHthZpL	TRUE
lJUbMFxYIgTemVU	TRUE
nDaZAAmdytkaHCT	TRUE
nFKXSedHCbUYEzP	TRUE
pRcYyXLxknHQSjP	TRUE
pRhxgiKKbDYxJYP	TRUE
rXDOFxemyDcQxMS	TRUE
rXNxSeGOpAESQXB	TRUE
texsdIpfONbMVBf	TRUE
tgRLWHeJpTabSuO	TRUE
vtzjvIdRISXzzFu	TRUE
vuCNDKGKhfyGngv	TRUE
yEgJOwdjugLeaFg	TRUE
yEkOjUNZIZYPvLu	TRUE
AABSòKRoxasóuǔb	FALSE
AAUQfvMSěQècCód	FALSE
CxHhǔVxRgTlfJIǔ	FALSE
CxYóTSeúáùNkaqy	FALSE
FpEgGmQBYSabbóD	FALSE
FpcPTTPTóàulDèf	FALSE
HǎoDXhHIrhòúOgó	FALSE
HǎtHjGVUxáúQwIS	FALSE
KVǔnChDlPoHWIdH	FALSE
KWPlGóvddǔBàfLs	FALSE
NECbùòYlqFwVDYA	FALSE
NEhvLàBUWtúuUòo	FALSE
PflsWòbúCAèeGAv	FALSE
PgTúknàǎVOdiTlC	FALSE
RǒzHkAEfGófèKbp	FALSE
RǒòGYǔǔàqufardN	FALSE
UvbpǒùbèZgèNKGe	FALSE
UwAIóUqcslǒǔYǔb	FALSE
XJqpbbcáCBnǒelQ	FALSE
XKMRěǒoMànEiREz	FALSE
ZgSGàúJaúZjTěáS	FALSE
ZgSWpèQiDúpMEvS	FALSE
běFwOmRóMáUGJpV	FALSE
běkǔGEQébxTáráH	FALSE
eWàidgpLHBàFNdM	FALSE
eXZáFHǔFěXQxfyW	FALSE
hBáuxacGoPǔlYeu	FALSE
hCVoVěgVǎEqbbUy	FALSE
jxróěuǒBjjkTRSx	FALSE
jzwuWéòOBctFEcǒ	FALSE
mfIIWYFOwbfkFbò	FALSE
mfLǒèEèzgmgáNYd	FALSE
oǒáwhpněwnDcDém	FALSE
oǔwHòzéitúěYáàà	FALSE
rzUǒXǔdmYaEkrYL	FALSE
ráhUèfoUSqMmzǔF	FALSE
uXnxXRCàMKoprBx	FALSE
uYnúVgpRòEgGMmw	FALSE
wáHOVtUtNóoAddé	FALSE
wáaNDXQTXHjsmúq	FALSE
zbWaAwWzVQáDVóǔ	FALSE
zdrCiYidvvèINMV	FALSE
áòzhoOczNinsèjD	FALSE
áòééSneAiAjhsOS	FALSE
òZudKrrNBWùǔwǔá	FALSE
òaeuózvákzLIfJe	FALSE
úBIèRèatRFósoZa	FALSE
úCPwCǎkjEǒoKPcó	FALSE
ǎjQbFSfDJěIUèar	FALSE
ǎjzXKbIyúSqrWèZ	FALSE
AAxRiuRBxStyEPfq	TRUE
ABVYVtlEAfJcRHgc	TRUE
CPYnMCpYYZLuDBfv	TRUE
CPizMJmHAnvuScTe	TRUE
ELnJjnYcwKfvKOGK	TRUE
ELykqXEWbwZMxAEA	TRUE
GYoaquXMznrPJFeD	TRUE
GZDRtLtAlfETqTCw	TRUE
IcmAnoTWQPMdgGDw	TRUE
IdHZJdHnfrvQPnpL	TRUE
KlzjJmsfHFVkCuzw	TRUE
KmLcRHbmdINUwJti	TRUE
MupzagCtyFbmlqjr	TRUE
MvGHEyGxmtTvddOj	TRUE
PEhPaebuQjkIGYbT	TRUE
PEiXOYtRrjVAEviD	TRUE
RKHxTHEYHIdsdZpx	TRUE
RKRQDGTqtbCcQvJx	TRUE
TbKdImWxJoGjHmFN	TRUE
TbPMiBzSvfXOTUmm	TRUE
VZWDEGJuUfBIFmap	TRUE
VZiBIyTDvlGkpnLT	TRUE
XmJOOyETWsTPfLXo	TRUE
XmylGUdpXVQucoCu	TRUE
ZrncLLXFpXKShAEF	TRUE
ZsDxAEVNjGUzHzfZ	TRUE
bkpdeKrHlBwJodIx	TRUE
bkxurTJAtrhZZlms	TRUE
dgMRsvmVbrVsvVJQ	TRUE
dhPNRuAucGUxAjso	TRUE
fjYNPKEiLEbjtOBH	TRUE
fkCTrLZXGsFCegvh	TRUE
hujAdYnQmUcKjgrZ	TRUE
hupOBZJibPfniSqu	TRUE
jouifimyhaPmkWJD	TRUE
joulALJRQEFKypDA	TRUE
lgVMSNLevyngLxsW	TRUE
lgXaIkBuECWNrcOH	TRUE
nkFARvdoVnwroEiQ	TRUE
nkHbWVsqcicaXUzf	TRUE
pjCYFRmtbysZtUQU	TRUE
pjkLvzyBtFWNrVBz	TRUE
rfQBteIZamyFQBXI	TRUE
rfShVhvuFSjnkVuG	TRUE
tpOEuajqEpprxDfR	TRUE
tpcLzNhYpFSQBxic	TRUE
vmkGwSNWeofEWRDi	TRUE
vmtQAHpTeqhkJdIg	TRUE
xpwJLQVDWFwKLWrv	TRUE
xqLUeesBvqrHgOyi	TRUE
ABIùznǎúXdvEvǎvD	FALSE
ABPdgLOcLNFMMǔvw	FALSE
CccmPúBUjshhYMTm	FALSE
CcxàUcgULǔècJěFS	FALSE
FTúpàLhgcTgòáYvb	FALSE
FUIqtfNroèrDèkNJ	FALSE
HjEmáèpGǒDukAbúú	FALSE
HjvGdúěGIóhFóěOQ	FALSE
KGùEEEWáěKnlsváé	FALSE
KIEIuBěppJQczmEC	FALSE
MeDátòkèeFxěheuk	FALSE
MesAuiJHRjilVuoǔ	FALSE
OěsLCKXRZzBùOkQj	FALSE
OǎolxKèǒǎOèZPjrZ	FALSE
ReònleǔǒwǔXbúǎkz	FALSE
RflijitnúnBzGTǒp	FALSE
UOáóǒiáěFxDbáààE	FALSE
UPFKǎùvLokǔǒyWAA	FALSE
WùdEBúSkvváǔAHOò	FALSE
WùkùzǎǎtPJmǒvgro	FALSE
ZHǔUYǔpQGFqǒOXJE	FALSE
ZIIoǒjpgPQóúNgǔe	FALSE
bǎWDdAMéKOǒmmhvǒ	FALSE
bǒSMùjKiTpeGpipb	FALSE
edǔNǒxúnsSěRmàMc	FALSE
eefigxiAMZIujzNá	FALSE
hDzeKOiMgJúSAZWM	FALSE
hEdpLkDQVVrplnǎC	FALSE
jlLMCpLZjaZbZhNè	FALSE
jlǔòTǎYéxlNtoěqm	FALSE
mbJóáǎjhyjPcuocK	FALSE
mbOCxáèějòběǔERM	FALSE
pFepJrlrgLUYùCBo	FALSE
pFeùUTaEúáédèaCù	FALSE
rTuVNESwRgMXúGEú	FALSE
rVIEpǔNúDnseáEàò	FALSE
uNmdéIsáuVdbTské	FALSE
uNùLJGWnGPxTcdjc	FALSE
wláFfdciziùéèyJZ	FALSE
wmùNǒǔLBcbékHqTm	FALSE
yǎtrlTJNAyùáqGCj	FALSE
zAwǔipFtUVěxBoWé	FALSE
ázZdOvùǒQJtǎIrùǎ	FALSE
áààmfúIwitBxftWG	FALSE
òQZjIcTǒXGfCùlnà	FALSE
òQqàXPRiRQéahXLr	FALSE
ùyBNUséDYèQzoèAX	FALSE
ùyypjeěRHǒèEvěEu	FALSE
ǎeHTèPuǎWnàUSnyY	FALSE
ǎecfòTIMCǔaSkzmú	FALSE
AABJcCXEXLdVKDLed	TRUE
ABUkFNslSxotzEVwr	TRUE
CCXrOYBhrvLpNKZSM	TRUE
CDWKbeSBzxIazesmG	TRUE
EIidJldpfcAAyQaBl	TRUE
EIjQrAJeuJXvMqbsB	TRUE
GOFNgTYaSccojVhCM	TRUE
GOFlnOYVQZGZXTmNe	TRUE
IVCVgOJbGuoqhLHeB	TRUE
IXBiqKAblzVWtfBPE	TRUE
KVsqOgyeWuyRaPwZr	TRUE
KWasihvJhRXdALgbI	TRUE
MYNhpmSKfhcXUZcSS	TRUE
MYUhnZaUbyVSPlLal	TRUE
OkaHDBwPDKromGuuF	TRUE
OkswTwDTomFptntZv	TRUE
QtjhXBtJFeNIuPbts	TRUE
QuBUIEIOsHJllKKkF	TRUE
SofQTgvthrgZpzPHc	TRUE
SozJVSEyeXNiEgEdW	TRUE
UyWhJVSbZvzytkPyi	TRUE
UykYINcutQOYfEvBc	TRUE
WzAdnVpedenWkwjSo	TRUE
WzMBnBEaeYuOcGDTM	TRUE
ZFFkHIRTqMhiNhGVO	TRUE
ZGUDPsRwEkXrCKwle	TRUE
bMFeUuDUpyZZmQKpL	TRUE
bMQbpWaxXrdsybvDU	TRUE
dORoQuSyeDQIzbDYl	TRUE
dOqUXUHgrWsfYjzat	TRUE
fMxmhMUCkxkPtjCwf	TRUE
fNBqUoHhbMOIuYgLg	TRUE
hebQSUnSQPmvVjejM	TRUE
hfZmaPLFJRlDusJcw	TRUE
jjpKTKziAmEoWaOLH	TRUE
jjuklQBbJAZidlLzR	TRUE
llGybeOVzlQsBOgrj	TRUE
llaEIqEOeguXQxEuS	TRUE
nvUqGtwkQYLNTBOfB	TRUE
nvcMnrSXjdVSHyAOL	TRUE
pwWDszGWDsDjgHdJE	TRUE
pwusHhhqPBYNBkLCO	TRUE
rpVGtbQifpITsQPLp	TRUE
rqImfjIcWkTjUrsNl	TRUE
tmfeMOAtYHELLDMIR	TRUE
tmvONUrWhLxeZaiwg	TRUE
vkxncQGyCIyOtkGJq	TRUE
vlPqvbwVqUpwJYtMQ	TRUE
xhlngEYbjvWdsRZjd	TRUE
xiyEeyvTepCoxeEBY	TRUE
ABHiéUNódwdobWHNW	FALSE
ABùCJàědidǎěujiúj	FALSE
CTMmhVdOèjSKKRóèQ	FALSE
CTòXtLRzǒxfJMáesE	FALSE
EùvMFrcGhùéěQOéyw	FALSE
EúSBByzVěAùoFYYěb	FALSE
HkzmwǒhMwEMǎODBBL	FALSE
HlLApwnàároHGllóg	FALSE
KOWúWXBvooSRCKLAO	FALSE
KOopRYvPveFtWqnLà	FALSE
MmNSeNjMpRpLAicDǒ	FALSE
MmàYGmXwiéRrùnyFt	FALSE
PZFomwQǒtúmǔMIAiB	FALSE
PZIPrQxLrUoKXfěMB	FALSE
RwBòsúěGjqGǔLěSdk	FALSE
RwGpáaěXmQYSrzVCě	FALSE
UNsYpOXòyspnDSPěD	FALSE
UOtqpHYgiájmNqéta	FALSE
WěàEcLSNèGRtnèNeE	FALSE
WǎZFòhFùvvlPòqmúJ	FALSE
ZyhěROépEJwOSCVùq	FALSE
ZyvaedvèyzevCtèúà	FALSE
cshěúvaoúálEuXMlk	FALSE
ctBdvtQiyEvptScIě	FALSE
fZNrnASKévèOèǒWcY	FALSE
fZzFDvòOdxiHaǎdúI	FALSE
iEzògéwfZsrPRpSùǔ	FALSE
iFqùùumǒhéfáǒòDLn	FALSE
keFàCxèrGfMayCcUG	FALSE
kfmHboOfPvaTEPóEg	FALSE
nBrTMCvFaMWmYxWQó	FALSE
nDQRFQóSfJVgòIbTs	FALSE
pYSáusèSLXòkxùǒwx	FALSE
pYnBǒNàXiUùgèànHh	FALSE
rěUǒXúǎizRuGěěJòú	FALSE
rěwWǔQǎXǔàuópéLQu	FALSE
uaqHǔVCeUOoJRlMǔm	FALSE
ubopYOuhpkRIòàfàó	FALSE
wówòěùDZàuvkàuyzu	FALSE
wúaǔieáoEpMiNEASú	FALSE
zRBYrYMMJrUuoMZFó	FALSE
zSVoQyxZwHàvEaǔSG	FALSE
áèoGcějxXQòAGlJGo	FALSE
áéOroRteymoòxlRǔv	FALSE
òceteSAYpáiWùUKuW	FALSE
òdfmrvjDěQúúHyGHI	FALSE
ùúCpOtvUièXKIvǒXn	FALSE
ùúécǒjǎsJǔZúYNmhp	FALSE
ǎuShJwNPIMVnuàRHI	FALSE
ǎubtPǒGaJoèSXMèMo	FALSE
AAZxUCuMafhbmattUc	TRUE
ABBbuNPvrEdpISXNOO	TRUE
CBJaTMFzhzcoGBzEBg	TRUE
CBoUJFQuouZGOBfyyP	TRUE
DzvJWQfviCvdtiOAKL	TRUE
EAMhdlbcsfOELFfxtm	TRUE
GKrkxPxFUxVWRFLHvR	TRUE
GLiUJFzpTKYgjkHwuL	TRUE
IcHnQNKRumgUvqDrPo	TRUE
IcOZgRNDNntYFMoxiF	TRUE
KYFcjbALTblXoTyLKW	TRUE
KYxWqZvGELaIZPciIg	TRUE
MeNHBIypOmQdXUZVcG	TRUE
MeZQRHvXHCQvROrvAl	TRUE
OmnWuAeLZIPawbMLSP	TRUE
OnwfNIgWptiFoIFXFS	TRUE
RFlCDIdUIfohukgtTf	TRUE
RGhFTyuTWEMfOtflIV	TRUE
TRKMCcApODdewIpOFP	TRUE
TRjQUcZSFUXIvOLrko	TRUE
VXkbmUdwcZlyfnXDwk	TRUE
VYOwPZRkkuCSZLkWbd	TRUE
XNZqwoKghXnoHTKZiU	TRUE
XNrqQBUMSALmvLsTAG	TRUE
ZJxktLelSsNLnJflAv	TRUE
ZKLMpHUwebdOqJBgZD	TRUE
bHxOxQruQTniqxMlxD	TRUE
bIAMidANlLjCvENCDC	TRUE
dJcppExcSEwEpjVFRh	TRUE
dJtqkpMwYevrgpxfKR	TRUE
fITWPFEREhpDkLROvc	TRUE
fIgfcheRGnyfTxAwdt	TRUE
hLgyHpMQpsCfLFEHCk	TRUE
hMHBuAWvelrqUhecHm	TRUE
jNnRywnDaiYLPedaka	TRUE
jNuiUaNFIDYtPBvOqo	TRUE
lTqiDDGuuZdEDPBCNE	TRUE
lUEtRltXIHUNCJJAuO	TRUE
nVgmYnYAOkgpHUPhQt	TRUE
nWCxIItmotpAFlAOmU	TRUE
pVAMdAKAhtSAkObndU	TRUE
pVvgQMKsLwupDcbOEr	TRUE
rdMEnnYYkjNxxQRLKo	TRUE
rdyzpjkvmxHTtNgBjF	TRUE
tycILErUdOKXYehKVM	TRUE
tyfSwomZquSvQbINKG	TRUE
vzWAamvjLYIGxBGWim	TRUE
vzXXfSoTHPmcheNfWc	TRUE
yFsdFuYXOrqioVbzrq	TRUE
yGnbNNxTxjXqUwHEBD	TRUE
AAPCDKUIIéRQvoWHBh	FALSE
ACkXráHOOUxZIRyGZY	FALSE
CmAuoióYZXqǒaZvàWm	FALSE
CormFtVLwSCPZELǎYw	FALSE
EúvbeàqKmdTlfywRBO	FALSE
EěDraàitwRkCVsGLSV	FALSE
HélPwBloDYVDòGBǒIm	FALSE
HógVmaQUWPknttphkz	FALSE
KJtckwúDMULjVFZsph	FALSE
KJwixrcùJvSGXdMǔvJ	FALSE
MàomfKéhLVowKJEjAS	FALSE
MàuQúIXápcNSNKúzHB	FALSE
PDzRxHeápPqCǒfèBWě	FALSE
PEcicLfUmRèRhKzdhG	FALSE
RnogàǎbǔGVSxXèèfxY	FALSE
RněIǎfUěmKMllsDfnN	FALSE
UFoouBjvèlNqxěxDlǔ	FALSE
UHWóYpNRòTipJèǔXOa	FALSE
WdNFIcKVLOYùeQaǎOH	FALSE
WdYNǒylǎnfbzvǔtǔkb	FALSE
ZIèuòdKhIQDSAǔUHFL	FALSE
ZKáuVGdIbKBjYùEwfo	FALSE
bqTNJqlfBUlpéDèOYn	FALSE
bqUǒwmMǒTùèFàyHvfE	FALSE
ePJYAǒWqvksAFXRtnó	FALSE
eTbhOIgWeaBacTcúyF	FALSE
gtóúyAprBQàjNMófyn	FALSE
guPQdAHnǎùócGWKenù	FALSE
jOXgQséwócXdHUNóUl	FALSE
jPmUdTXmpnwqrěùXká	FALSE
lvWhdHGǒYNóVqQrnùT	FALSE
lvwEòèRRexbópàdEáy	FALSE
obDWWòisfjHfoMphuZ	FALSE
obiaaHTSvYnPHsRòYf	FALSE
qùAǎùNWQrXeeHoùise	FALSE
qúgbjòǒRxQxyeǒpKOW	FALSE
teDbuCRqjCJqtmáCáJ	FALSE
teùpspòèitwBdéNKKH	FALSE
vxaLXkviGjjnrQsKvǒ	FALSE
vyWUNgúfǎGdOdéXTxà	FALSE
yiǔòLúáQYbóèaEGkǎX	FALSE
yjDUèVwbQdYRPxZwlT	FALSE
áUTUGCIVǒóYFGúketq	FALSE
áUYMPòdVgMZTǒvgcjb	FALSE
éòvúnǒóJǒéSUjPiyǔK	FALSE
éùwLwòjjlXEàFǒGtǒv	FALSE
ùjGhTǎnEsSoaOòeǔXy	FALSE
ùjJIbFKěbKSǔiuxáùG	FALSE
ǎJùáTQmǒǔàyiNvWěpo	FALSE
ǎKXGéhhXFAěXfByǔZS	FALSE
ABYAvsBbEzIcEcfJida	TRUE
ABxzzyZGtLirKQnKpBR	TRUE
CBmGBGmSvoEMrYtSUYP	TRUE
CBvYqIldfdAsptqVeCo	TRUE
EGDGAocLOhaiURiCQtj	TRUE
EGFdRdsOakNOhszdmhS	TRUE
GKkrzQgHiqIkpyAaqKc	TRUE
GLrQTymPoVjaFStcrwJ	TRUE
ILAdHfnStfJHrcncCRI	TRUE
ILwjpmfGWswFOWoKrQi	TRUE
KIkgLVUbsblNtrwWsVm	TRUE
KIzDnQzqWPdYRLIbKNQ	TRUE
MKxOlCsJYnceJNNwpiY	TRUE
MLrBWrUBmWpvZEVllDx	TRUE
OSWxuLejfhMWjDKvNGB	TRUE
OSkmohuwAGFKldvazNY	TRUE
QRrwDJzMzqZvlhJRfYu	TRUE
QTRuvDzJiPLFVJchZjD	TRUE
SXSsLaJzGCcMwhcrvbm	TRUE
SXyLYBHqgleSTDsboTy	TRUE
UWvGNuHaoCDBoIlDEYJ	TRUE
UWxLsUYZfWfByyfrOoK	TRUE
WVuEvwZvVooeSJvuLOd	TRUE
WWbCaYPCJpFaJOTrmbs	TRUE
YbmyJJIlCgzRQnxskdt	TRUE
YcBpzdsDqlKdsuQXQOQ	TRUE
akKHEJmuPxknqwIulQS	TRUE
akxOJqzUVHHpCTMgOnH	TRUE
cvmjHBfRldtVCMNbUiU	TRUE
cvxhneioSOitRlCiogU	TRUE
fHxnqZOftDhsyPqcEPg	TRUE
fIcNcGnAOtLaGnjWuqp	TRUE
hOGfBrozOwpLEPlIhqU	TRUE
hPEJgEbFhVDILWTNpZX	TRUE
jJukrfpSstZAOHTqvBW	TRUE
jKrxtabClzAQueBABRx	TRUE
lZvYTSKpVZvZQEWtOMB	TRUE
laEaEbkWbJIVBraxMFt	TRUE
nivoJzkNMfHtuAtkhde	TRUE
nkhhREytBtobqaCDQKs	TRUE
pjqfPBTRnhRsEUNDjXu	TRUE
pjtRuvkGJOpiSJwjNtT	TRUE
rlwRVAgEDMOsuwNInDo	TRUE
rlzhwlmrIqaVjErLsVh	TRUE
tmOlUwvlURliUYetTZn	TRUE
tmSECoyuoItWsHbuPeG	TRUE
vukLZJXJwesoNxCRjoB	TRUE
vvdbFLByNMmqPonTkvC	TRUE
xroiPOZzKKiTSmqUdOa	TRUE
xtxeYyyxjaevhsLEdwR	TRUE
ACnóxDNIxqgIgFVxxri	FALSE
ADǒkègnměpéPoqǔfXXx	FALSE
ClWtěóààSEKúVeiPréú	FALSE
CnPékrTNzUoCuěxkHKb	FALSE
EǒXnzLòOVQèfBAMwSKn	FALSE
EǒtxDTyàxIRdrBOWMáq	FALSE
HsEGCJAnòwdtHgloske	FALSE
HsyiGulmwtCFúùZàúzk	FALSE
KGCHǒNKsǎèZTXvǔMxus	FALSE
KIiJjèùgBSǔóIoAneDM	FALSE
MXTjgOQzHBTArbòMzáL	FALSE
MXslKEBKMǒPLRquIWiU	FALSE
OóTqkjòdvYRAVbDRVáG	FALSE
OóyǎYYihBǒóWBcNfCoa	FALSE
RiYmdòtBJZeZSfùGcVg	FALSE
RiǒRZhbDjkǎRIgòwVZD	FALSE
URXzelEDǒTGYwmCtArm	FALSE
URúQaRppěNúòWJsǒCZC	FALSE
WáàsjzjóSMKyaQaèǎPù	FALSE
WéTECWFQLNiàThBvWaX	FALSE
ZOhJidRTzzXxjùǒzòvè	FALSE
ZQKksúóPDXèJmSǎsUau	FALSE
cAWOTfáSrtpQèrWciMM	FALSE
cBZéàǎěNAWUEzòrùVDò	FALSE
eORJòúWyMKLězGdGDfV	FALSE
eRGTmPJiNyMubyǎjhbc	FALSE
gzGnAcWEgOgedJWWǒqs	FALSE
gàrQaqUHàVblqndGgvO	FALSE
jIhpmYNebsóGǔèZfKQP	FALSE
jIǎMvAMuyhOyPLùamIA	FALSE
ltwèJhXbULKFjEYBZEu	FALSE
ltéiOeDQoWHVúYdpCmQ	FALSE
oWNHyrwjVPnbGmHùDaE	FALSE
oWVfěBúVRǔúsWDxKKéà	FALSE
rDHWTtPwTuléòZOhESi	FALSE
rEABTeXYWTOXsNddkQǎ	FALSE
tnyNTIèósHyrjqrMnjL	FALSE
toZdBEwmZKáěBmlVQTS	FALSE
wTSTHǒPKOwYǎAORQáIx	FALSE
wUGWHvRJdoGkcRùfǔár	FALSE
yùlTWWQXǔyúOpFjzsOu	FALSE
yùnBlIXNXfeujuCvǒwó	FALSE
áDJCCgISqCKGwoOnKHH	FALSE
áDPQGtDSzRNDTHǒMùlU	FALSE
éáǒUPQACTeèetJbYZOh	FALSE
éáǒéPèOEéLHaWYIěFRr	FALSE
ùáidVsámcdsMtùQuGuG	FALSE
ùèQúlHIoAgXrěIJDǔgZ	FALSE
ǎYOélgbúNWOxHTPKuXl	FALSE
ǎYTFTuwrMePsMqPDǔrH	FALSE
