aaaaaaaddd	TRUE
aaaaaacadc	TRUE
aacccddacc	TRUE
aacccddddd	TRUE
aaddddcadb	TRUE
aaddddcdcd	TRUE
abccadcacc	TRUE
abccaddccd	TRUE
abddddacca	TRUE
abddddadad	TRUE
accaddcdac	TRUE
accaddcdca	TRUE
acddaccdca	TRUE
acddacdaac	TRUE
adcadadcca	TRUE
adcadaddad	TRUE
addccacdaa	TRUE
addccacdaa	TRUE
caacddadaa	TRUE
caacddcacd	TRUE
cacdadacdd	TRUE
cacdadcaca	TRUE
caddcdaddc	TRUE
caddcdcdcb	TRUE
ccadddddad	TRUE
ccadddddcc	TRUE
ccdacaacaa	TRUE
ccdacacada	TRUE
cdaaadccaa	TRUE
cdaaadcdaa	TRUE
cdcadaddca	TRUE
cdcadccadb	TRUE
cddcacaccd	TRUE
cddcacacdc	TRUE
daacadcdac	TRUE
daacaddcad	TRUE
daccaddddd	TRUE
dacccaaacb	TRUE
dadccddadd	TRUE
dadccddadd	TRUE
dcacdcdaad	TRUE
dcacdcdada	TRUE
dccdaaadac	TRUE
dccdaaadcd	TRUE
dcddadcdca	TRUE
dcddaddadd	TRUE
ddadacdcac	TRUE
ddadacdccc	TRUE
ddcddadddc	TRUE
ddcddcaacb	TRUE
aaaaabddcc	FALSE
aaaaabdddc	FALSE
aacccddabb	FALSE
aaccdabbbd	FALSE
abbacbbdcc	FALSE
abbacbccdb	FALSE
abdcbdabcc	FALSE
abdcbdcdba	FALSE
accbbcbdaa	FALSE
accbbcddcc	FALSE
adadbdcbda	FALSE
adadcabbcd	FALSE
addcaacdba	FALSE
addcabaacd	FALSE
babdaddacb	FALSE
babdbaabca	FALSE
bbacaacdcd	FALSE
bbacacaadb	FALSE
bbdaababcd	FALSE
bbdaabbdad	FALSE
bcbcaaccdd	FALSE
bcbcabaccb	FALSE
bdaaddbcba	FALSE
bdabaaabca	FALSE
bdccbdbdac	FALSE
bdccbdccdd	FALSE
cababadbac	FALSE
cababbabab	FALSE
cadccadaba	FALSE
cadccbabbb	FALSE
cbcabcacdb	FALSE
cbcabdbcab	FALSE
ccacccadbc	FALSE
ccaccccbad	FALSE
ccdabccddc	FALSE
ccdabcdbdc	FALSE
cdbdcaccdc	FALSE
cdbdccabbd	FALSE
daadbcbdcd	FALSE
daadcbabad	FALSE
dadadbbcba	FALSE
dadadcbbbd	FALSE
dbbdcbaadd	FALSE
dbbdcbacdd	FALSE
dcaadabaca	FALSE
dcaadaccbd	FALSE
dcccacaaba	FALSE
dcccacaabc	FALSE
ddbbcccada	FALSE
ddbbcdacdb	FALSE
aaaaaaaddda	TRUE
aaaaaacaddd	TRUE
aaccccdaada	TRUE
aacccdaadcc	TRUE
aaddddadadd	TRUE
aaddddcaadc	TRUE
abcccccddac	TRUE
abccccdcada	TRUE
abdddcdcddc	TRUE
abddddaaddd	TRUE
accaddaccdd	TRUE
accaddadaab	TRUE
acddcccaaac	TRUE
acddccccdca	TRUE
adcacdadccd	TRUE
adcacdcaaab	TRUE
addcaddacad	TRUE
addccaaaccb	TRUE
caacdcddadd	TRUE
caacddaacaa	TRUE
cacdacaaccc	TRUE
cacdacadccb	TRUE
caddccacaca	TRUE
caddccacacb	TRUE
ccadcdcacda	TRUE
ccadcdcdacc	TRUE
cccddcdcdcb	TRUE
cccddcddccb	TRUE
cdaaaccdcab	TRUE
cdaaacdaacb	TRUE
cdcadadaadb	TRUE
cdcadaddaca	TRUE
cddaddddacc	TRUE
cddaddddacc	TRUE
daacaccdacd	TRUE
daacaccdcdb	TRUE
daccadddcdc	TRUE
dacccaaaada	TRUE
dadccccdaca	TRUE
dadcccdaddb	TRUE
dcacdadaaaa	TRUE
dcacdadaccd	TRUE
dcccddddccc	TRUE
dccdaaadcdd	TRUE
dcddacccccc	TRUE
dcddaccdadc	TRUE
ddadadddcdb	TRUE
ddadcaacada	TRUE
ddcdcdddaca	TRUE
ddcdcdddcac	TRUE
aaaaabddcca	FALSE
aaaaabdddcd	FALSE
aacdaadcbbd	FALSE
aacdabadbda	FALSE
abadabcadcd	FALSE
abadabdbcac	FALSE
abdcadcbbaa	FALSE
abdcadddcab	FALSE
accadacbdad	FALSE
accadadcbdd	FALSE
adadddaadbb	FALSE
adadddccabc	FALSE
addcabbacbb	FALSE
addcabbcdbb	FALSE
bacaaabbcdb	FALSE
bacaabcacbd	FALSE
bbacbddbcbb	FALSE
bbaccbdadbd	FALSE
bbdaaccbaac	FALSE
bbdaacccaaa	FALSE
bcbbccabdad	FALSE
bcbbccacbaa	FALSE
bdaaabbdcca	FALSE
bdaaabddadc	FALSE
bdcdbbacacb	FALSE
bdcdbcdbbac	FALSE
caadcdcbbbc	FALSE
caadcddaabb	FALSE
cadcbbbadcd	FALSE
cadcbbbcddc	FALSE
cbcbbbbcbad	FALSE
cbcbbbccbda	FALSE
ccbaacdbdac	FALSE
ccbaadcbccc	FALSE
ccddacadcbd	FALSE
ccddbaadcba	FALSE
cdcbbacacba	FALSE
cdcbbccccbc	FALSE
daacdcddabb	FALSE
daadabacdda	FALSE
dadaccddbba	FALSE
dadadaaccbb	FALSE
dbbdcccccba	FALSE
dbbdcdaaddb	FALSE
dcacbbdaccc	FALSE
dcacbcbaaad	FALSE
dcdaadabccc	FALSE
dcdaadbccca	FALSE
ddbcbdccbad	FALSE
ddbccaabadb	FALSE
aaaaaaacadaa	TRUE
aaaaaacadaca	TRUE
aaccaadcadcd	TRUE
aaccaadcdccb	TRUE
aaddadacddac	TRUE
aaddadadacdb	TRUE
abcadaaadddd	TRUE
abcadaacdaad	TRUE
abdcdcccacdc	TRUE
abdcdcccdaac	TRUE
accaaccacccd	TRUE
accaacccddda	TRUE
acdccdcaadaa	TRUE
acdccdccaaac	TRUE
adcaccaaaccb	TRUE
adcaccaaadda	TRUE
adddacaacccb	TRUE
adddaccaaaab	TRUE
caaddcadaddd	TRUE
caaddcccccad	TRUE
cacdddacdddd	TRUE
cacdddcaccdd	TRUE
caddddcacaad	TRUE
caddddcdacac	TRUE
ccaddcdcddcd	TRUE
ccadddaaddab	TRUE
ccdaaadcaadc	TRUE
ccdaaadccada	TRUE
cdaaadcadcca	TRUE
cdaaadccdacd	TRUE
cdcacdcccadd	TRUE
cdcacddcaaab	TRUE
cddadcacdcab	TRUE
cddadccaaacb	TRUE
daaaddaddcaa	TRUE
daaaddcccdcb	TRUE
dacaddaddcab	TRUE
dacaddcaacca	TRUE
dadcaaddadda	TRUE
dadcaadddcaa	TRUE
dcacccccaaad	TRUE
dcacccdaacdd	TRUE
dcccdaddddaa	TRUE
dcccdccdaadb	TRUE
dcddadaccacd	TRUE
dcddadacdcca	TRUE
ddadccddccdd	TRUE
ddadcdaaadcd	TRUE
ddcddacadcaa	TRUE
ddcddaccccdc	TRUE
aaaaaaaaacbd	FALSE
aaaaaaddbbbd	FALSE
aacbbcbbcdbd	FALSE
aacbcbbddcdb	FALSE
abaddbddacdd	FALSE
abaddcbcccaa	FALSE
abdbcbabdada	FALSE
abdbccaaadbb	FALSE
accbaacdcbad	FALSE
accbaadcbbdc	FALSE
adbaaabdacbb	FALSE
adbaaacabcdd	FALSE
addcaddbbaad	FALSE
addcbbabbdac	FALSE
bacadcdaaadc	FALSE
bacadcdbdacb	FALSE
bbacbbddbdaa	FALSE
bbacbcbabadc	FALSE
bbdbadccdcab	FALSE
bbdbadcdacca	FALSE
bcbdbbacdcbb	FALSE
bcbdbcbbcbdd	FALSE
bdabbdbbaaca	FALSE
bdabbdbccccc	FALSE
bdccdbcaacac	FALSE
bdccdcdadabc	FALSE
caadddbcddbd	FALSE
caadddcccdbc	FALSE
cadcabddbcba	FALSE
cadcacacbdbb	FALSE
cbcaddbbbada	FALSE
cbcaddcdbacb	FALSE
ccacdddadabd	FALSE
ccacdddbdcdc	FALSE
ccdbddbbdddc	FALSE
ccdbddcdaadb	FALSE
cdbdaababbab	FALSE
cdbdadddccdd	FALSE
daaaccbbcddd	FALSE
daaacccabcbc	FALSE
dadabacbddbd	FALSE
dadabbcdbcad	FALSE
dbbcabaaddcd	FALSE
dbbcacaddcbd	FALSE
dcaababcbdcc	FALSE
dcaabbacbbbb	FALSE
dcccbcabdccc	FALSE
dccccabadbcd	FALSE
ddbbaacadcac	FALSE
ddbbaadccdcc	FALSE
aaaaaaacadaac	TRUE
aaaaaacdacaad	TRUE
aaccacccacddd	TRUE
aaccacdccdcad	TRUE
aaddccaddccdb	TRUE
aaddcccadddca	TRUE
abcaccccddadc	TRUE
abcacccdaadac	TRUE
abdccdcdcccca	TRUE
abdccdddadacc	TRUE
acaddcaccaccc	TRUE
acaddcadccadc	TRUE
acdcaccddddab	TRUE
acdcacdcadcdd	TRUE
adcaaacaccdda	TRUE
adcaaacadacad	TRUE
adddacdcaacaa	TRUE
adddaddadddcb	TRUE
caaddcaadaaab	TRUE
caaddcacaddca	TRUE
cadaadaddaadb	TRUE
cadaadadddcdc	TRUE
ccaaaaccdcaca	TRUE
ccaaaaccdddca	TRUE
cccaaacddcccc	TRUE
cccaaaddcadaa	TRUE
ccdaaddaacccc	TRUE
ccdacaacaadaa	TRUE
cdaaaddaaccdd	TRUE
cdaaaddaccada	TRUE
cdcacacaaaccb	TRUE
cdcacacadaddb	TRUE
cddacadcdadcb	TRUE
cddacccccdcaa	TRUE
daacaaacdcdcb	TRUE
daacaaadcacac	TRUE
daccaccdcadaa	TRUE
daccaccddaccb	TRUE
dadcccddcaaac	TRUE
dadcccddccddc	TRUE
dcaccddccadcc	TRUE
dcaccddccccdd	TRUE
dccdadcdadadb	TRUE
dccdaddadaaad	TRUE
dcddcadcacaab	TRUE
dcddcaddaaddc	TRUE
ddadcdadcdaac	TRUE
ddadcdaddaddb	TRUE
ddcddadcacdca	TRUE
ddcddadddccda	TRUE
aaaaaaabaabdb	FALSE
aaaaaabbcacdd	FALSE
aacbbcabdbccb	FALSE
aacbbcacdcccc	FALSE
abadbadcdddcd	FALSE
abadbbabdcaac	FALSE
abdbdaabbbbbb	FALSE
abdbdadcdcabc	FALSE
acbdcaaacdccd	FALSE
acbdcabdacadd	FALSE
adacccaacdbaa	FALSE
adaccdacdaabb	FALSE
addbcadbccbda	FALSE
addbcbabddbac	FALSE
babdddadcbbdd	FALSE
bacaabdacadab	FALSE
bbaccabcbccda	FALSE
bbacccdbcbccc	FALSE
bbdadcdbcbadc	FALSE
bbdaddacabada	FALSE
bcbdabbcbbdab	FALSE
bcbdabbdcacca	FALSE
bdaabdcdcacda	FALSE
bdaacaccdccbc	FALSE
bdcdbdbdbdbda	FALSE
bdcdccbdddabb	FALSE
cabcccbdcbdbc	FALSE
cabccdbccbdbd	FALSE
cbaadbabccabd	FALSE
cbaadbcddcaba	FALSE
cbcdbdabcbbbd	FALSE
cbcdbdddabbad	FALSE
ccbacbaaddcdb	FALSE
ccbacbadbdccc	FALSE
ccddabbbcdacc	FALSE
ccddacbacadbc	FALSE
cdcbbccdbcdab	FALSE
cdcbbdaccdbcd	FALSE
daaddbaacccac	FALSE
daaddbdbbcbda	FALSE
dadcdacbabdad	FALSE
dadcdcbcadddc	FALSE
dbcbabaaadcca	FALSE
dbcbabbbaaaaa	FALSE
dcacdcaabaccb	FALSE
dcacdcaabcccd	FALSE
dcdaabcaccccb	FALSE
dcdaacadbccda	FALSE
ddbbcdaddcabd	FALSE
ddbbcddcacdcc	FALSE
aaaaaaaaacdaaa	TRUE
aaaaaaaaadacda	TRUE
aacaddcacaaacb	TRUE
aaccaaaaaadcca	TRUE
aaddacaaccaadc	TRUE
aaddacaacddddc	TRUE
abcacaddadcacc	TRUE
abcaccddadacca	TRUE
abdccddccddddc	TRUE
abdccdddaddadd	TRUE
accaadcdcdaadd	TRUE
accaadcddcddaa	TRUE
acdccdadcdadab	TRUE
acdccdadddccad	TRUE
adaddddcdcacdb	TRUE
adcaaaaadacadc	TRUE
addcadddadddcb	TRUE
addccaadcaadca	TRUE
caacdadcdacacb	TRUE
caacdcaaaddcdc	TRUE
cacdcadadaadad	TRUE
cacdccaaacacad	TRUE
cadddcadacdaaa	TRUE
cadddccccaadad	TRUE
cccaaacdcddadd	TRUE
cccaacaacaadaa	TRUE
ccdaccaddcdadd	TRUE
ccdacccdcadada	TRUE
cdacaaaaadaaaa	TRUE
cdacaaaacddcac	TRUE
cdccadccacdddc	TRUE
cdccadccdaccdc	TRUE
cddcdacdaadacb	TRUE
cddcdacdccdadd	TRUE
daaccddaadadab	TRUE
daacdaacaacdca	TRUE
daccdaacdaccaa	TRUE
daccdaacddadaa	TRUE
dadcddcacccdad	TRUE
dadcddccaadacb	TRUE
dcadaaaccacaac	TRUE
dcadaaacddadab	TRUE
dcccdddcadaddc	TRUE
dccdaaaadcdcab	TRUE
dcddadccaadacb	TRUE
dcddaddaddcdca	TRUE
ddadadcacadcaa	TRUE
ddadadcccaccdd	TRUE
ddcdadacaccddc	TRUE
ddcdadacddaaaa	TRUE
aaaaaadcacccba	FALSE
aaaaabbdddaacc	FALSE
aacddcabbcccca	FALSE
aacddcacccbccb	FALSE
abbcbcaddcabcb	FALSE
abbcbcbabbcdaa	FALSE
acabbcdacbaabc	FALSE
acabcbdabddadb	FALSE
acdacddabbaaad	FALSE
acdacddbcdabbd	FALSE
adbdbcaabccddc	FALSE
adbdbcabddbdcd	FALSE
baacbbbdababbb	FALSE
baacbbbdacaaaa	FALSE
badabdbcdbddad	FALSE
badabddcdaaaac	FALSE
bbbbddddbcccab	FALSE
bbbcaaadbacaab	FALSE
bbddcaabcddabb	FALSE
bbddcadadbbaab	FALSE
bccadbadadbdcc	FALSE
bccaddabdccdad	FALSE
bdaccbabcbadbb	FALSE
bdaccbadcdaaba	FALSE
bddcdacbddddac	FALSE
bddcdbbcdbbaca	FALSE
cacadabdbdbcdc	FALSE
cacadadcdbdddc	FALSE
cbbaadabbcadaa	FALSE
cbbaadcaadcaad	FALSE
cbdcbdacdabbdc	FALSE
cbdccabccddcab	FALSE
cccaadcccccabd	FALSE
cccabadddacdba	FALSE
cdacbabdddadbb	FALSE
cdacbadbcdacab	FALSE
cdcdcdcaacccba	FALSE
cdcddaccbbbddb	FALSE
dabbcddcbcaacb	FALSE
dabbdacaadcbac	FALSE
daddbdcddcbaab	FALSE
daddcaadcdbbac	FALSE
dbccacadbddaca	FALSE
dbccacdbdddaaa	FALSE
dcadbabbbcdcdb	FALSE
dcadbbbbddcdac	FALSE
dcdabadbbcbacc	FALSE
dcdabbacbabadc	FALSE
ddbbdddbaaccaa	FALSE
ddbcaaccaabbba	FALSE
aaaaaaaaddaacda	TRUE
aaaaaaadddddadc	TRUE
aaccdddccccacdd	TRUE
aaccdddccdcdccc	TRUE
abaadcddcaadcac	TRUE
abaaddaaddcdaad	TRUE
abcdaaacddacccd	TRUE
abcdaaadcaddcac	TRUE
acaaacddcaccccb	TRUE
acaaadaadccdcca	TRUE
accccdcdccadcdb	TRUE
acccdaadddcaacc	TRUE
adaaaddadcdcadc	TRUE
adaaaddcddccdab	TRUE
adccdccadaacada	TRUE
adccdccaddcaddd	TRUE
caaaaacddaccaca	TRUE
caaaaacddccacdc	TRUE
cacacacdacdcaab	TRUE
cacacacddcadadc	TRUE
cadaccaccaddadd	TRUE
cadaccacdddccca	TRUE
ccaaccdaaaddddb	TRUE
ccaaccdacaadcac	TRUE
cccacddaacdadad	TRUE
cccacddddacddac	TRUE
ccdcaccddcccaca	TRUE
ccdcaccddccccdb	TRUE
cdacacdddcaacdc	TRUE
cdacadaadaaacdd	TRUE
cdccccdaaadcccb	TRUE
cdccccdadccccda	TRUE
cdddaccdcaaccdc	TRUE
cdddaccdcaddcad	TRUE
daadacadcaaddcd	TRUE
daadacccacacddd	TRUE
dacdcddaacdacca	TRUE
dacdcddacdaaada	TRUE
daddccdacaacdca	TRUE
daddccdcdacaccc	TRUE
dcadccdddddaccc	TRUE
dcadcdaaccdaaca	TRUE
dccdcaacdcaccdb	TRUE
dccdcacadccadca	TRUE
dcddadacaaadacc	TRUE
dcddadacccdcdaa	TRUE
ddaddadaccccccb	TRUE
ddaddadacdccdaa	TRUE
ddcdcdcaaddccab	TRUE
ddcdcdccdacdddc	TRUE
aaaaaaabbdbbbcc	FALSE
aaaaaacccddbdda	FALSE
aacbbdcbdbbbada	FALSE
aacbcaabacabbac	FALSE
abaccdcdcdabbdc	FALSE
abacdaabaacdaaa	FALSE
abdbabababbbbaa	FALSE
abdbaccbdadbdbd	FALSE
accadcdaacbabbc	FALSE
accaddbadcbacbd	FALSE
adacababacdbbdc	FALSE
adacabdbacbbbdd	FALSE
addabdcacbdacdc	FALSE
addabdcccdbcacc	FALSE
babdbbabcdcddad	FALSE
babdbcbcbdacccd	FALSE
bbacacababccdca	FALSE
bbacacbdbcbbada	FALSE
bbcddccdcdbcada	FALSE
bbcddcdaaadbbcc	FALSE
bcbcbabdadbcaab	FALSE
bcbcbbbabcdbcba	FALSE
bdaaccbacabadbb	FALSE
bdaacdaddabcdbd	FALSE
bdccdddbdbacaad	FALSE
bdcdaaaccbbccdd	FALSE
cabacddcadbccab	FALSE
cabadaccddcaddd	FALSE
cadcdbcbaabaada	FALSE
cadcdcacccbbaad	FALSE
cbcbdbbaaacdcab	FALSE
cbcbddaacdcccbd	FALSE
ccacdadcdbbadac	FALSE
ccacdbbcacbcadd	FALSE
ccdadabcddadbdd	FALSE
ccdadcdadcababb	FALSE
cdbdaacbbcbbcbb	FALSE
cdbdaaccbdcdbcb	FALSE
daaaccdbaacdcda	FALSE
daaaccddccbbcba	FALSE
dacbdcbdbadcdda	FALSE
daccaadbbddcddd	FALSE
dbbbadcddccabaa	FALSE
dbbbaddabbdbaaa	FALSE
dbdddbbcbcdddbd	FALSE
dbddddbadbddbba	FALSE
dcccabbbdbddbdd	FALSE
dcccadbaddadadb	FALSE
ddbbbbcabbcbcdd	FALSE
ddbbbcbddaddbbd	FALSE
aaaaaaaaddacaddc	TRUE
aaaaaaacdcaadadc	TRUE
aacccccaaadacaad	TRUE
aacccccacddcacad	TRUE
aaddcdaadaddcdcb	TRUE
aaddcdacccaddddd	TRUE
abcadcaaadaadaad	TRUE
abcadcaaddcaccca	TRUE
abddcccdaddcccaa	TRUE
abddccdaaadacaca	TRUE
acccacaddccdaacc	TRUE
acccacdaaadcccda	TRUE
acddccaaaaccdadb	TRUE
acddccaaaddddccc	TRUE
adcaddacdadddadb	TRUE
adcaddacdcadddac	TRUE
addcdccdcdddcdac	TRUE
addcdccddccdadda	TRUE
caaddadccaddcacd	TRUE
caaddcaaaaccdaca	TRUE
cacdddcdcadaacac	TRUE
cadaaaacdadcadca	TRUE
ccaaadaaaddcdcdb	TRUE
ccaaadaadddadddc	TRUE
cccaaddadcccdaac	TRUE
cccaaddcaadcddab	TRUE
ccdacacdaadccdcd	TRUE
ccdacacddaaaddda	TRUE
cdaadaadddcacddb	TRUE
cdaadadaadcccacd	TRUE
cdcaccdacdddaada	TRUE
cdcaccdadaccdada	TRUE
cddadacacaaddaca	TRUE
cddadacaccddacaa	TRUE
daaacdccaaccacdb	TRUE
daaacddaaaddcccc	TRUE
dacadcdaaaaaadad	TRUE
dacadcdadcaadcaa	TRUE
dadaddcdcacdccac	TRUE
dadaddcdccdadddb	TRUE
dcaaddacccaaddac	TRUE
dcaaddacdcddacac	TRUE
dccaddcdccddaaca	TRUE
dccadddccaddcccb	TRUE
dcdccadcddccdacd	TRUE
dcdcccaadcaaacaa	TRUE
ddadaaadcdddacdb	TRUE
ddadaaccdccdccdc	TRUE
ddcdadadcadccadd	TRUE
ddcdadaddcdaacda	TRUE
aaaaaaaacbbdbdac	FALSE
aaaaaaacadcbadda	FALSE
aaccbcaacaacddcd	FALSE
aaccbcdbdacbdbdc	FALSE
abadcdbdadcbddcb	FALSE
abaddabadddcbdcb	FALSE
abdbddacdaadcbba	FALSE
abdcaadaacdcdddb	FALSE
acbdddccbbcddaac	FALSE
accaaaabccdbccbb	FALSE
adadaadbdbcddbdd	FALSE
adadabccccbacaac	FALSE
addcacbabbadabcc	FALSE
addcadbcadadaaaa	FALSE
bacaadabccdcabba	FALSE
bacaadaccbbccbad	FALSE
bbacddbbaddcabac	FALSE
bbacdddcddcdbdcc	FALSE
bbdbbdbabaacdcba	FALSE
bbdbbdbcacacbbcb	FALSE
bcbdbbbdbaaaacbc	FALSE
bcbdcacadbbcaddd	FALSE
bdababacddabacbc	FALSE
bdababadbbbadbda	FALSE
bdcdccaabbbddbda	FALSE
bdcdcdcbadcaaacc	FALSE
cabcdbaadadcdacb	FALSE
cabcdcdcdcadabad	FALSE
cbaabbdcdadddccc	FALSE
cbaabcccacbdcbad	FALSE
cbcccbababddcbca	FALSE
cbcccddbccddcccc	FALSE
ccbabadcbbcbdbac	FALSE
ccbabbabaaabbcdc	FALSE
ccdcdcddcbcabddd	FALSE
ccdcddbcdbcbccbc	FALSE
cdcadbaadddaaccc	FALSE
cdcadbdabacdadcd	FALSE
daacaadddaacabdc	FALSE
daacabbdcccccacb	FALSE
dadabddadaaccbbb	FALSE
dadacaacbbcbbbdc	FALSE
dbbccddaadbdccda	FALSE
dbbcdaaccaaaacdb	FALSE
dcaaaddacadaadbd	FALSE
dcaabccbabbddada	FALSE
dccccccaddddcabc	FALSE
dccccdaabdbcbbcc	FALSE
ddbbabbbbabdbbac	FALSE
ddbbabbdccaccbba	FALSE
aaaaaaaddcadccccb	TRUE
aaaaaacacccaaaccd	TRUE
aaccaacccdacadcaa	TRUE
aaccaacdacaacccda	TRUE
aaddaddccdddcccca	TRUE
aaddadddccdaacdcc	TRUE
abcaccaacacadcadc	TRUE
abcaccaddcdacacdd	TRUE
abdccdcacaccdccda	TRUE
abdccdcddcdadaada	TRUE
acaddacaadccacacd	TRUE
acaddaccaacccdccb	TRUE
acdcadacacadaaccd	TRUE
acdcadcdcccadcadc	TRUE
adadcccccaacdcdca	TRUE
adadcccdccadcadcb	TRUE
addadacadddadcdad	TRUE
addadaccdaaacaccb	TRUE
caacaccccdccaddca	TRUE
caacacccdadcaccdd	TRUE
cacccadcdccadcaac	TRUE
caccccadaadadaacd	TRUE
cadcaddadddccccdc	TRUE
cadcaddcccdddaddb	TRUE
ccacdcadddacdacdb	TRUE
ccacdccacddcadacd	TRUE
cccdaaaaacaaaacad	TRUE
cccdaaaacdadaadab	TRUE
ccddcdddadadaacdd	TRUE
ccddcddddccadacda	TRUE
cdaddddcaacaccccd	TRUE
cdcaaaaacdcaadccb	TRUE
cddaccaacacadaccc	TRUE
cddaccacaddcdacdc	TRUE
daaadccdcdaaacada	TRUE
daaadcdaccdacadda	TRUE
daccaccddcdcacdab	TRUE
daccacdaaddaacdca	TRUE
dadcdadadcadaaccc	TRUE
dadcdadcddaacdacd	TRUE
dcadaacacadaddaad	TRUE
dcadaacacdddaacad	TRUE
dccdcaaaacccaccdd	TRUE
dccdcaacaccdccccc	TRUE
dcddcadacddcadadb	TRUE
dcddcaddaaccdadcb	TRUE
ddadcddacccddcdab	TRUE
ddadcddadacaaccaa	TRUE
ddcddcdddccccacad	TRUE
ddcdddaacacacadcc	TRUE
aaaaaaaaadbddbbca	FALSE
aaaaaabbbdadbbdbd	FALSE
aacbdcabbaabbdada	FALSE
aacbdcccbbdcdbccc	FALSE
abadbdaddcdccdddb	FALSE
abadbdcaaccadccdb	FALSE
abdbaacdcabaddbab	FALSE
abdbaadddbacbbdab	FALSE
acbdbaadabcdcbcca	FALSE
acbdbacbccaadcaad	FALSE
adaaddddabcdbaaab	FALSE
adabaacccddadaada	FALSE
adcdaaaaccabdddab	FALSE
adcdaaababbdccbac	FALSE
babbbacbbcbccabbb	FALSE
babbbccdadadcddcd	FALSE
bbabbdbcddadaaacb	FALSE
bbabcbadbcbddcadb	FALSE
bbcdbadddbdabbbbd	FALSE
bbcdbcdabdccdadcb	FALSE
bcbcacbadbddbbbdb	FALSE
bcbcacccbccacbbbb	FALSE
bdaaccaabcbccbdac	FALSE
bdaacdbcaadbddbca	FALSE
bdcbcbbacdbbcbdca	FALSE
bdcbccdcadccbddaa	FALSE
cabaadbacddaabcdb	FALSE
cabaaddccbadcccca	FALSE
cadcdccdbcdadaccb	FALSE
cadcddbacbcbabcad	FALSE
cbcabbabbdbdacbab	FALSE
cbcabbbaabbacdbad	FALSE
ccabdcdbcaadbdabc	FALSE
ccacaabacbbccbcdc	FALSE
ccdabbcbbdddcdccd	FALSE
ccdabcaddacadcbaa	FALSE
cdbdcdadabbcbbdaa	FALSE
cdbdcdbdaabbdbcba	FALSE
daacbadadbddcaaba	FALSE
daacbbbcabdcdabbc	FALSE
dadbadcababbcadbd	FALSE
dadbadcadbcbddbcb	FALSE
dbbccdabccbabadbc	FALSE
dbbcdacdbddbbdbad	FALSE
dbdddcbddcaabcaac	FALSE
dbdddccbbadddddad	FALSE
dcccaddababcbdada	FALSE
dcccaddabbcbcdbab	FALSE
ddbbcacdbaacdcabd	FALSE
ddbbcbacacadcdbcb	FALSE
aaaaaaaaacdacaccaa	TRUE
aaaaaacddaadddcdca	TRUE
aaccadcaacadccaddc	TRUE
aaccadccdacdadccca	TRUE
aaddcaacaaccdacdaa	TRUE
aaddcacccdacccdaad	TRUE
abcacdaccdcaaaddaa	TRUE
abcacdacdaaaadcdcd	TRUE
abdcddadcccaaddddc	TRUE
abdcdddacccacacaad	TRUE
accacdaacaccccdaac	TRUE
accacdadacaacaccca	TRUE
acdcdddacdcaccdccc	TRUE
acddaaadacaaacccdd	TRUE
adcaaaccacaaaaaaca	TRUE
adcaacaaaddacaadaa	TRUE
addcdddccacaddaaab	TRUE
adddaacddaccadaccd	TRUE
caacddaccdcccdaccd	TRUE
caacddacdddcacacac	TRUE
caccddacaadcccaccc	TRUE
caccddadccacadadcd	TRUE
cadcddddccddaaaddb	TRUE
caddaacaaacdadccab	TRUE
ccacdccccaccaccdad	TRUE
ccacdcdcccaccaadad	TRUE
cccdcacaccddccacac	TRUE
cccdcacdcdaaddcddd	TRUE
ccddcccddaaacdadaa	TRUE
ccddccddaddcaadacb	TRUE
cdcaaacacdacdaddaa	TRUE
cdcaaacacddacccdcd	TRUE
cddacacaadacaacacd	TRUE
cddacacccccaccdada	TRUE
daaacddcdacadccaab	TRUE
daaacdddcaadadcdad	TRUE
dacaddccadcaadddad	TRUE
dacaddcccdaadaaadc	TRUE
dadcadaadccaacdcac	TRUE
dadcadacaaaddccaaa	TRUE
dcacdadacacdaadcdc	TRUE
dcacdaddadcdaadccb	TRUE
dccdacdacdaccdacca	TRUE
dccdacdcaadcaddaca	TRUE
dcddadcaadaaadcdcb	TRUE
dcddadcadaaaccaccb	TRUE
ddadcadddaaddcacca	TRUE
ddadccaacacacacacc	TRUE
ddcdcdccacdccacdda	TRUE
ddcdcdcdadacdccaad	TRUE
aaaaaacccddabdaaba	FALSE
aaaaabacdaacdcdddc	FALSE
aacbcdcbabbbbcaccc	FALSE
aacbdaddcdaccddbcc	FALSE
abbabcacaccdbbbcad	FALSE
abbabdbacbabbadadc	FALSE
abdcdbdaaabdcadbaa	FALSE
abdcdcabbdbacbdaac	FALSE
accbbcccbddddbddcb	FALSE
accbbdcbdcbddbcdbc	FALSE
adacdbdcbacddbdbca	FALSE
adacdccdbdddcdaaba	FALSE
addbbadbcccbcccaca	FALSE
addbbbadcdccbdbacc	FALSE
babcbddcccbacbdbba	FALSE
babccbaabcdacabddd	FALSE
bbabadcdabadccaada	FALSE
bbabbbabadcbdacdbd	FALSE
bbcdccaaadacabacca	FALSE
bbcdccbccdbbadacdd	FALSE
bcbcddbbadcbbbbcdc	FALSE
bcbcddccbdddcdbbbc	FALSE
bdacdbdaadcdaacbbc	FALSE
bdacdbdbbadadbddca	FALSE
bdcdcdcddcbbaccadc	FALSE
bdcdcddadcbbdcabda	FALSE
cabbdcacacbadcbabb	FALSE
cabbdcbbdddbdbdbba	FALSE
cbaabccbbbdbdbcdad	FALSE
cbaabdaabaccabbadb	FALSE
cbcbcbccabbdbccbba	FALSE
cbcbccbbcacabbdcad	FALSE
ccadcadbcacaabddbc	FALSE
ccadcadddddddacbcd	FALSE
ccdbadbacbaccddbbb	FALSE
ccdbbaacbcacbbaaaa	FALSE
cdbdccabdbaaaadbad	FALSE
cdbdccdbccbdbbdadb	FALSE
daaadcdbaacddbadcd	FALSE
daaaddadddccccbdbb	FALSE
dacdcbcdacdbdabacc	FALSE
dacdcbdccbdbcadbdc	FALSE
dbbcdbdddcbabdcdbc	FALSE
dbbdaaabcabaccbcba	FALSE
dcabbbcddbadacadda	FALSE
dcabbbdbaabaaabaca	FALSE
dccdbaabdaccddbcbb	FALSE
dccdbabcadccacbdcc	FALSE
ddbbadbbbaabadbbbc	FALSE
ddbbbbabacabaaccdc	FALSE
aaaaaaaacddcadcdaab	TRUE
aaaaaaacdaaddcaaadb	TRUE
aaccccaddcddaaadcac	TRUE
aacccdaccadaacddcca	TRUE
aadddadcdaaadaddddd	TRUE
aadddcacdadcddcacda	TRUE
abcccacdacadcdcddaa	TRUE
abcccacdcddccaddaad	TRUE
abddcdaacacadacccca	TRUE
abddcdcacddaaacadcd	TRUE
accadcccdccaccadadd	TRUE
accadccddccdccadcdb	TRUE
acdcdcdacaaacdcdaca	TRUE
acdcdcdcacaccdaddcb	TRUE
adaddcddcccddacadaa	TRUE
adadddaccdaccdddcdd	TRUE
addccccaacaaccacdca	TRUE
addcccccacdcdaddcda	TRUE
caadadcdaacccacdadd	TRUE
caadadcdcdaacddaddd	TRUE
cacdcacdccccdaaaccd	TRUE
cacdcadaaaccacdddcd	TRUE
caddacdaadcdaccacad	TRUE
caddacdcdcccaaacacd	TRUE
ccadcdddadcccccdcdc	TRUE
ccaddaadaaccadaccdb	TRUE
cccddddddccdadccadd	TRUE
ccdaaaaadaaacaddccc	TRUE
cdaaaacdacaacdcdada	TRUE
cdaaaadacddcccaccad	TRUE
cdcadaddcacaaacdcaa	TRUE
cdcadaddccaccadaccb	TRUE
cddadacdcaddcddaada	TRUE
cddadacddcadcaacada	TRUE
daacaccdaddcdaccaab	TRUE
daacaccdccccadccdab	TRUE
dacccddcdaaaddccdaa	TRUE
daccdaaaddddcdccada	TRUE
dadcddccadaaddcacdb	TRUE
dadcdddaaacddddcadb	TRUE
dcadadcaaacadaadcca	TRUE
dcadadcaacdddcaaadc	TRUE
dccdcaccaaaadcdcacb	TRUE
dccdcacccaddcacdcda	TRUE
dcddcdaadcadddacccd	TRUE
dcddcdadaaaccacaaca	TRUE
ddadcdcdcdddaacaaab	TRUE
ddadcdcddcacaadaddc	TRUE
dddaaacdadcddaadcdb	TRUE
dddaaadacddaacaacab	TRUE
aaaaaacdddbccbbaddd	FALSE
aaaaaadadccbadcccbc	FALSE
aaccdacaacdcddcccbd	FALSE
aaccdbccaaccadbcdbd	FALSE
abbaabdddccabacbcda	FALSE
abbaacbaaabcaccaddc	FALSE
abdccdbcdadbcadddcc	FALSE
abdcdbbadadcdbcadda	FALSE
accbcdaaacccbdbccad	FALSE
accbcddcacabddcccad	FALSE
adbaabddbdabcddacca	FALSE
adbaacbaacaaacddddd	FALSE
adddaadbdcaaabaaaab	FALSE
adddacdbabbcdddccdb	FALSE
bacbadabdcdacbccdcb	FALSE
bacbbbbcaadadbdcdba	FALSE
bbaddadbddaacdcbcba	FALSE
bbaddcbbacddcdaaada	FALSE
bbdbdadbaccaadbbcac	FALSE
bbdbdcacdbccbbabaab	FALSE
bcbdddbccdcabcbdcdb	FALSE
bccaaabbacdabdbbcad	FALSE
bdadbcbbaacbaaaabbb	FALSE
bdadbddcdccbadcbabc	FALSE
bddcdaccaaaaabdccdd	FALSE
bddcdaccbccadabbbdb	FALSE
cacadadacbaadbdacdc	FALSE
cacadbabcabaddcaddd	FALSE
cbabbdacabaccddadbc	FALSE
cbabbdacacdbbaaccac	FALSE
cbcdbbabcccadcadacc	FALSE
cbcdbcaddcadbaddbdb	FALSE
ccbabbccbadbdabbabb	FALSE
ccbabdbaacacbcaddad	FALSE
ccddbbbdcdaddbdbbcc	FALSE
ccddbccadddbacaaaba	FALSE
cdccadddbdcaddbbccc	FALSE
cdccbaabdbcbaadaada	FALSE
dabbcbbccbbdbddbcda	FALSE
dabbccdaddccacdcbcd	FALSE
dbaadccadcddcdacaab	FALSE
dbaaddaccdccaaaaabb	FALSE
dbccbcacddacadcbdcc	FALSE
dbccbccccbcaaacdbcd	FALSE
dcbaadcbdabcacaabba	FALSE
dcbabaabacacbbbaaaa	FALSE
dcdbdcaccabddbbddaa	FALSE
dcdbdcadaacdacbaabc	FALSE
ddbccccbdccbbaccbcc	FALSE
ddbccdbacccdddaaaaa	FALSE
