aaaaabbccb	TRUE
aaaaacbcab	TRUE
aacbccaccb	TRUE
aacbdbddcb	TRUE
abadcbbdbb	TRUE
abaddaaabb	TRUE
abdbcaadab	TRUE
abdbcbdacb	TRUE
accadacccb	TRUE
accadbbadb	TRUE
adadbccabb	TRUE
adadbcdbcb	TRUE
addbddacdb	TRUE
addbddcdbb	TRUE
babddbcabd	TRUE
babddbdacc	TRUE
bbabdbdaba	TRUE
bbabdbdbad	TRUE
bbdaacdddc	TRUE
bbdabaaacc	TRUE
bcbcdaaacd	TRUE
bcbcdabcdc	TRUE
bdaaababdd	TRUE
bdaaacbccc	TRUE
bdcbcacdda	TRUE
bdcbcaddbc	TRUE
caadcbdabd	TRUE
caadccdaad	TRUE
cadbccbdba	TRUE
cadbccdddc	TRUE
cbcbbaadcd	TRUE
cbcbbccbcc	TRUE
ccbaacabad	TRUE
ccbaadabdd	TRUE
ccdccadcba	TRUE
ccdccadcda	TRUE
cdcaacdabd	TRUE
cdcaadabac	TRUE
daacbabada	TRUE
daacbadcac	TRUE
dadabbaabc	TRUE
dadacaadaa	TRUE
dbbccbbddd	TRUE
dbbccccbad	TRUE
dcabcacbac	TRUE
dcabccabcd	TRUE
dcdbdbcbcd	TRUE
dcdbdcaaca	TRUE
ddbcdacbba	TRUE
ddbcdcabaa	TRUE
aaaaaaabcd	FALSE
aaaaaabbad	FALSE
aacbdbaaba	FALSE
aaccaaadba	FALSE
abbabbbadc	FALSE
abbabcabbd	FALSE
abdcddccbc	FALSE
abddabbabd	FALSE
accbbabbdd	FALSE
accbbacdba	FALSE
adacdbddba	FALSE
adacdcacca	FALSE
addaccaaac	FALSE
addacdacda	FALSE
babccaabcb	FALSE
babccacbcb	FALSE
bbaabcadcb	FALSE
bbaacacadb	FALSE
bbccdaddcb	FALSE
bbccdbdaab	FALSE
bcbbdbcbbb	FALSE
bcbcaaddbb	FALSE
bcddccaacb	FALSE
bcddccaadb	FALSE
bdcbaadcdb	FALSE
bdcbababab	FALSE
caadbbaddb	FALSE
caadbbdcbb	FALSE
cadbcacaab	FALSE
cadbcbacbb	FALSE
cbcadbadcb	FALSE
cbcadccbdb	FALSE
ccadcaaddb	FALSE
ccadcbccab	FALSE
ccdbaabbdb	FALSE
ccdbaadcbb	FALSE
cdcacbaddb	FALSE
cdcacccaab	FALSE
daadbcbdbb	FALSE
daadbdcdcb	FALSE
dadbbbdbbb	FALSE
dadbbcdddb	FALSE
dbcaabadcb	FALSE
dbcaacaabb	FALSE
dcabdbcadb	FALSE
dcabdbdadb	FALSE
dcdabaadbb	FALSE
dcdabbbdab	FALSE
ddbcdabacb	FALSE
ddbcdacaab	FALSE
aaaaaaabcdb	TRUE
aaaaaabadcb	TRUE
aaccaccbabb	TRUE
aaccadbaccb	TRUE
abbaabaabab	TRUE
abbaabaabab	TRUE
abddadbcabb	TRUE
abddaddaacb	TRUE
accbabdcadb	TRUE
accbacbaabb	TRUE
adadabdabbb	TRUE
adadabddabb	TRUE
addabccbcab	TRUE
addabdaaddb	TRUE
babcdbcabba	TRUE
babcdcdabcc	TRUE
bbaabccbadd	TRUE
bbaabcccaba	TRUE
bbcbcdadbba	TRUE
bbcbdabbcba	TRUE
bcadbaddaaa	TRUE
bcadbbcaaad	TRUE
bcdcbacbbba	TRUE
bcdcbcaacdd	TRUE
bdcabdcdcba	TRUE
bdcacbbcbdd	TRUE
caadbbdbdca	TRUE
caadbdccada	TRUE
cadbbbcbbac	TRUE
cadbbcbbdca	TRUE
cbbdcdcaaaa	TRUE
cbbdcddcadc	TRUE
ccacddacaac	TRUE
ccadaacdcbc	TRUE
ccdbddcbaba	TRUE
ccdbddcbaba	TRUE
cdcabdbcaad	TRUE
cdcabdcccad	TRUE
daadcbdabac	TRUE
daadcccbbad	TRUE
dadbbcbbadc	TRUE
dadbbcccdbd	TRUE
dbbddbbadcc	TRUE
dbbddcdaccc	TRUE
dcabcadbdaa	TRUE
dcabcbacaca	TRUE
dccddbcccad	TRUE
dccddddcaaa	TRUE
ddbbddabbdc	TRUE
ddbbddabcdd	TRUE
aaaaaaabcdc	FALSE
aaaaaabadcd	FALSE
aaccaccbaba	FALSE
aaccadbaccd	FALSE
abbaabaabac	FALSE
abbaabaabad	FALSE
abddadbcabd	FALSE
abddaddaacd	FALSE
accbabdcadd	FALSE
accbacbaabc	FALSE
adadabdabbd	FALSE
adadabddabd	FALSE
addabccbcaa	FALSE
addabdaaddc	FALSE
babcdbcabbb	FALSE
babcdcdabcb	FALSE
bbaabccbadb	FALSE
bbaabcccabb	FALSE
bbcbcdadbbb	FALSE
bbcbdabbcbb	FALSE
bcadbaddaab	FALSE
bcadbbcaaab	FALSE
bcdcbacbbbb	FALSE
bcdcbcaacdb	FALSE
bdcabdcdcbb	FALSE
bdcacbbcbdb	FALSE
caadbbdbdcb	FALSE
caadbdccadb	FALSE
cadbbbcbbab	FALSE
cadbbcbbdcb	FALSE
cbbdcdcaaab	FALSE
cbbdcddcadb	FALSE
ccacddacaab	FALSE
ccadaacdcbb	FALSE
ccdbddcbabb	FALSE
ccdbddcbabb	FALSE
cdcabdbcaab	FALSE
cdcabdcccab	FALSE
daadcbdabab	FALSE
daadcccbbab	FALSE
dadbbcbbadb	FALSE
dadbbcccdbb	FALSE
dbbddbbadcb	FALSE
dbbddcdaccb	FALSE
dcabcadbdab	FALSE
dcabcbacacb	FALSE
dccddbcccab	FALSE
dccddddcaab	FALSE
ddbbddabbdb	FALSE
ddbbddabcdb	FALSE
aaaaaaabcdcb	TRUE
aaaaaabdcddb	TRUE
aaccacccbccb	TRUE
aaccadadbcdb	TRUE
abbacaccbbcb	TRUE
abbacadcddab	TRUE
abdcccbcdccb	TRUE
abdccccaaabb	TRUE
accaddacbbcb	TRUE
accaddcbaabb	TRUE
adadbacadddb	TRUE
adadbbcacacb	TRUE
addacdcabccb	TRUE
addadaacadcb	TRUE
babdabcabdac	TRUE
babdbcccbcdd	TRUE
bbacdbaaddca	TRUE
bbacdbdbcdba	TRUE
bbdabcbacacc	TRUE
bbdabdabcaac	TRUE
bcbcdacbdddc	TRUE
bcbcdadbaacd	TRUE
bdabcadbbccd	TRUE
bdabcbaaccbc	TRUE
bdcbddbbcddc	TRUE
bdccaabdcabd	TRUE
caadacabccda	TRUE
caadacbadcba	TRUE
cadbdabdadcd	TRUE
cadbdccbbaac	TRUE
cbcbbdccbcad	TRUE
cbcbcaadbaaa	TRUE
ccbaabbaccac	TRUE
ccbaadacdbbd	TRUE
ccddadabcbdd	TRUE
ccddbabbadcc	TRUE
cdcbbcacbbbd	TRUE
cdcbbdbcdcca	TRUE
daadadbadbad	TRUE
daadbaabdaca	TRUE
dadbbcacaaaa	TRUE
dadbbdaaddba	TRUE
dbcaacbcccda	TRUE
dbcaadbbaddc	TRUE
dcaccbabcaaa	TRUE
dcaccbbccaba	TRUE
dcdabbbaddcc	TRUE
dcdabcdcdada	TRUE
ddbcacddcbac	TRUE
ddbcbdaacabc	TRUE
aaaaaadbdbcd	FALSE
aaaaabddddbc	FALSE
aaccddcdadbd	FALSE
aacdacabbabd	FALSE
abbabdccbdcd	FALSE
abbabddcdccd	FALSE
abdbcacbdcac	FALSE
abdbdaacaccd	FALSE
acbdcdbaaccd	FALSE
acbddabbbdad	FALSE
adacbcaddbbc	FALSE
adacbdabadaa	FALSE
addaadaadada	FALSE
addaadcbabca	FALSE
babbdcbcddab	FALSE
babbddbbaccb	FALSE
badddbacaacb	FALSE
badddbadcadb	FALSE
bbccbccbbacb	FALSE
bbccbdadbdab	FALSE
bcbacdcaddab	FALSE
bcbacddccdab	FALSE
bcddcabaabbb	FALSE
bcddcacadabb	FALSE
bdcbdcdbcadb	FALSE
bdcbddabdcab	FALSE
cabbacaaadbb	FALSE
cabbacadacab	FALSE
caddaaddaacb	FALSE
caddabdaacdb	FALSE
cbcabccadbbb	FALSE
cbcabccbaacb	FALSE
ccadaddccbdb	FALSE
ccadbbcbcbab	FALSE
ccddbaddccab	FALSE
ccddbbaacadb	FALSE
cdcadbcdbbab	FALSE
cdcadcaccabb	FALSE
daadcddbddab	FALSE
daaddacacddb	FALSE
dadacbdddcbb	FALSE
dadaccbcdaab	FALSE
dbbcbcadaaab	FALSE
dbbcbddbbacb	FALSE
dbddcdbccbdb	FALSE
dbdddbdddcab	FALSE
dccbddddaaab	FALSE
dcccabbcbcbb	FALSE
ddbaddbbcbbb	FALSE
ddbbaabbcacb	FALSE
aaaaaadbdbcdb	TRUE
aaaaabdddbcbb	TRUE
aacdacbdcaadb	TRUE
aacdacdbbdbcb	TRUE
abbbabddabaab	TRUE
abbbacaabcabb	TRUE
abdcacbddbadb	TRUE
abdcadbdaadcb	TRUE
accabacdcddab	TRUE
accabadbccbab	TRUE
adacbbacdacbb	TRUE
adacbbbdabdab	TRUE
adcdddcdbdccb	TRUE
addaaacbbcdbb	TRUE
babcbdddacdbd	TRUE
babccabccccdc	TRUE
bbaabdcccdddc	TRUE
bbaaccbaacbba	TRUE
bbccdbcbbbbdc	TRUE
bbccdcdbdbada	TRUE
bcbbbaabbbbba	TRUE
bcbbbcbcaaadc	TRUE
bcddcaabcbbba	TRUE
bcddcaacbbcda	TRUE
bdccccacbbbdd	TRUE
bdcccccaadaac	TRUE
caadddacaabbd	TRUE
cabaaaaaacdac	TRUE
cadbbbaaddcca	TRUE
cadbbccadcadd	TRUE
cbcabbcbbabda	TRUE
cbcabbcdadccd	TRUE
ccadaccdcddcc	TRUE
ccadacdadcbaa	TRUE
ccdcaaccaadbc	TRUE
ccdcaadabdadd	TRUE
cdcaccbccbcdd	TRUE
cdcacdbbbccdc	TRUE
daadabaadbbcd	TRUE
daadadbdddbbd	TRUE
dadbadacaacac	TRUE
dadbbaaaabbcc	TRUE
dbbcdbadcdbca	TRUE
dbbcdbbababcc	TRUE
dcaaddbcbbdcd	TRUE
dcaaddbcddddc	TRUE
dcccddaaaaadd	TRUE
dcccddcdcbcac	TRUE
ddbbcbccbcaba	TRUE
ddbbccacadabc	TRUE
aaaaaddabaddc	FALSE
aaaaaddcccbaa	FALSE
aacccaddcddcc	FALSE
aacccbabcbdbd	FALSE
abbbacdbcbdbd	FALSE
abbbadaacbcbc	FALSE
abdcdcdddaadd	FALSE
abdcddaabaddc	FALSE
accadcabacadc	FALSE
accaddbccdcaa	FALSE
adadabdbcbaad	FALSE
adadadaddbdac	FALSE
addcbbbdbcddc	FALSE
addcbccdcabda	FALSE
bacadbccbdacb	FALSE
bacadcbdddcab	FALSE
bbacadcdcbabb	FALSE
bbacadddbacdb	FALSE
bbdabdbcccdbb	FALSE
bbdabdcbdcddb	FALSE
bcbccbdbaacab	FALSE
bcbcccdbaaddb	FALSE
bdaacbbacadbb	FALSE
bdaacbdbdbddb	FALSE
bddabbdadacab	FALSE
bddabcbccbbbb	FALSE
cabcbcbabaabb	FALSE
cabccaccbbcab	FALSE
cbaacaacaccbb	FALSE
cbaacaacbdbbb	FALSE
cbccbdacbdcdb	FALSE
cbccbdcabadbb	FALSE
ccbadcbcccbbb	FALSE
ccbaddabcbaab	FALSE
ccdcacdabcdbb	FALSE
ccdcadddabdcb	FALSE
cdcadddcadabb	FALSE
cdcbaabbcbbab	FALSE
daadacbdcdaab	FALSE
daadaccaabbdb	FALSE
dadbacdcbdbdb	FALSE
dadbadacacdcb	FALSE
dbbcdcacabbcb	FALSE
dbbcdcbdbcdbb	FALSE
dcaaddbddbaab	FALSE
dcaadddccdbbb	FALSE
dccdaaddcaaab	FALSE
dccdabbbcbcdb	FALSE
ddbbcddcbcccb	FALSE
ddbbdbadcbccb	FALSE
aaaaaddabaddbb	TRUE
aaaaaddcccccab	TRUE
aacccdbacdccdb	TRUE
aaccdaacdbabab	TRUE
abbbbcdccababb	TRUE
abbbbcddacaabb	TRUE
abddacdbcdbccb	TRUE
abddadabcdaabb	TRUE
accbabccdaaddb	TRUE
accbadbdbadddb	TRUE
adadcbcdbcaacb	TRUE
adadccaaddbdcb	TRUE
addcbdcaaacccb	TRUE
addcbdddbaaabb	TRUE
bacbccabaabbba	TRUE
bacbccbabcacdc	TRUE
bbbaabddccadba	TRUE
bbbaaccdbcdadc	TRUE
bbdcabcdbcdcbc	TRUE
bbdcabdbccacdd	TRUE
bccababaabdccc	TRUE
bccabbabaabbca	TRUE
bdaccccabbdada	TRUE
bdaccccbadbaac	TRUE
bddaadbbdbbdbc	TRUE
bddaaddacdbdcc	TRUE
cabcacbdacddbc	TRUE
cabcbbccadcdac	TRUE
cbaadaacbaabdc	TRUE
cbaadabaabaccc	TRUE
cbcdbcdbadbbaa	TRUE
cbcdcacbcbdbad	TRUE
ccbbaacbcabcad	TRUE
ccbbababbbdbdd	TRUE
ccdcdaccbacbcd	TRUE
ccdcdcaddcbdaa	TRUE
cdcbcbcccbdabd	TRUE
cdcbccdbbdadcc	TRUE
daadcbbcabccda	TRUE
daadcbbdacbbcd	TRUE
dadadcadaabadc	TRUE
dadadcbbbccadd	TRUE
dbbdcacbbdcdcc	TRUE
dbbdcccbaddaca	TRUE
dcabaccdaacccc	TRUE
dcabaddcbaccbc	TRUE
dcdadaaccacdaa	TRUE
dcdadabddddacd	TRUE
ddbcdddabbcdcd	TRUE
ddbcdddabbdabc	TRUE
aaaaabbadcbaca	FALSE
aaaaabcacccbbd	FALSE
aacdcabadbabbc	FALSE
aacdcaccdcbacd	FALSE
abbcbdcadcddcd	FALSE
abbcbddabbadbc	FALSE
abdddbaaaddbcd	FALSE
abdddbdacdcaba	FALSE
accbdabddddcbc	FALSE
accbdacbadabac	FALSE
adbacdcbacbacd	FALSE
adbacdddcacdaa	FALSE
adddbaabdbcdba	FALSE
adddbacddbadca	FALSE
bacacdcdcbcbbb	FALSE
bacadabdbcadab	FALSE
bbacaddcdaadab	FALSE
bbacbaaabbbddb	FALSE
bbdaddbbbdaadb	FALSE
bbdaddcacddacb	FALSE
bcbcdbbbacdbcb	FALSE
bcbcdbcdccdccb	FALSE
bdacadbabddacb	FALSE
bdacbaadcabdbb	FALSE
bddababbbdadcb	FALSE
bddabaddababdb	FALSE
cabcbcabbdbdcb	FALSE
cabcbdaaabdbab	FALSE
cadddbdacabbbb	FALSE
cadddcabccabcb	FALSE
cbcbdaabaabadb	FALSE
cbcbdabcdaaabb	FALSE
ccadadabcdacbb	FALSE
ccadaddbbbddcb	FALSE
ccdbacacdcdbdb	FALSE
ccdbaccacbcabb	FALSE
cdbdabadddadbb	FALSE
cdbdabddbdacbb	FALSE
daacaadcccbcbb	FALSE
daacabcccaddbb	FALSE
dadabbaacaaddb	FALSE
dadabbbbadbaab	FALSE
dbbdaadcabcccb	FALSE
dbbdabdbabcadb	FALSE
dcacabddcbbdab	FALSE
dcacadadacacdb	FALSE
dcdaccbbabcccb	FALSE
dcdaccdbbaaccb	FALSE
ddbbccabaaabcb	FALSE
ddbbcdbaabdbdb	FALSE
aaaaabbadcbacab	TRUE
aaaaabccccbbcab	TRUE
aacdbdbacbaaabb	TRUE
aacdbdbbbccbbab	TRUE
abbccbababdbddb	TRUE
abbcccacdabdbbb	TRUE
abdddbbbbbdbbcb	TRUE
abdddbcabaddacb	TRUE
accccadccbddddb	TRUE
acccccdddcdbbbb	TRUE
adbaccccdbadadb	TRUE
adbacdabadadbab	TRUE
addcdbaabbcaddb	TRUE
addcdbcddbddbab	TRUE
bacaccbbdcbaadc	TRUE
bacacccadbabbaa	TRUE
bbabdccbddbbdbd	TRUE
bbacaadcdcabbba	TRUE
bbdbcdacbdcabcd	TRUE
bbdbcdbadbddbcd	TRUE
bcbdcdbbdbdadca	TRUE
bcbddabcdcbddca	TRUE
bdaadcbaaccbdbc	TRUE
bdaaddadaddadda	TRUE
bdcdadbbbdaccca	TRUE
bdcdadcaadaccca	TRUE
cabadbcdccbbdbc	TRUE
cabadcbbcdbbdaa	TRUE
caddcabcabadddd	TRUE
caddcbbacaabbcc	TRUE
cbcbcacaaddddad	TRUE
cbcbcadcddadbcc	TRUE
ccadadcababdaba	TRUE
ccadbadcdbadbcc	TRUE
ccdbbdcddbbaccd	TRUE
ccdbcacdcbcdbcd	TRUE
cdbdccbacdacccd	TRUE
cdbddabdacbdcba	TRUE
daacbadcbccdaac	TRUE
daacbdaddbabdbc	TRUE
dadabacdcccadcc	TRUE
dadabadaabaacad	TRUE
dbbcbdcddccbadd	TRUE
dbbccadbddbaadc	TRUE
dbddcbdcdcccbad	TRUE
dbdddabdabacddd	TRUE
dcccbbaacbbabdd	TRUE
dccccabdcabacca	TRUE
ddbcacbdbaaabbc	TRUE
ddbcadaadacccac	TRUE
aaaaaaabbdaacdc	FALSE
aaaaaaccdcbabac	FALSE
aaccdbdcdadabac	FALSE
aaccdcabdbbcddc	FALSE
abbabdaccadacad	FALSE
abbacacaccddddc	FALSE
abdcbbdbcbabacd	FALSE
abdcbdcbadadada	FALSE
acbddccdbaadacd	FALSE
acbdddabaddcdbd	FALSE
adacbddbdaabbbc	FALSE
adaccbabbcaacbc	FALSE
addbaccaacddcaa	FALSE
addbadcdddbddaa	FALSE
babbddddbddcddb	FALSE
babcabdaabdaacb	FALSE
baddcdaadaacbcb	FALSE
baddcdbbcadbdbb	FALSE
bbcbddaddcccdcb	FALSE
bbcbddbcdbbcaab	FALSE
bcbabcaacdacadb	FALSE
bcbabdbacdcbaab	FALSE
bcddbaddcddddcb	FALSE
bcddbcddacaabcb	FALSE
bdcccccbbadbadb	FALSE
bdcccdbcddadcdb	FALSE
cabaadbbcdadaab	FALSE
cabaadcdddcccdb	FALSE
cadccdaaadcaabb	FALSE
cadccddbddbadab	FALSE
cbcabddcddbbdcb	FALSE
cbcaccacdbccdcb	FALSE
ccacccbbdcdbccb	FALSE
ccaccdadabbdbdb	FALSE
ccdbdadaabdbbdb	FALSE
ccdbddaddcbcadb	FALSE
cdcaaabaadcbbbb	FALSE
cdcaaabababbcdb	FALSE
daabdaaddaccdab	FALSE
daabdbdbdacccbb	FALSE
dacdbbbcbcaabcb	FALSE
dacdbcccaabcdbb	FALSE
dbbbcbcadaccbcb	FALSE
dbbbccbbcbdaacb	FALSE
dbddccbcbdaccdb	FALSE
dbddcdcbaacdaab	FALSE
dccccbdbddcdbdb	FALSE
dcccccddcdaddbb	FALSE
ddbbbacadcaaaab	FALSE
ddbbbacdbbadacb	FALSE
aaaaaaabbdaacdbb	TRUE
aaaaaacdcbababab	TRUE
aacccbdadbacadab	TRUE
aaccccbbddadbdcb	TRUE
abbaabcdcbaccbab	TRUE
abbaaccadccbcccb	TRUE
abdcacdaacbccbab	TRUE
abdcacdcaadabacb	TRUE
accaaddcdbcddadb	TRUE
accabaabcbcbddbb	TRUE
adadadbbcddbcdab	TRUE
adadbaadaacdddbb	TRUE
addbacbbdbcdabbb	TRUE
addbacccacdabdbb	TRUE
babccabbdbdbcaca	TRUE
babccadabaccdcdd	TRUE
bbabcdabdbadddcc	TRUE
bbabcdcdbbcdbbdd	TRUE
bbdabacadbcacbbc	TRUE
bbdabbaabcbdbbad	TRUE
bcbcabcdbaadbdcc	TRUE
bcbcacadadddddcd	TRUE
bdaadaccddbbaacc	TRUE
bdaadbcdbaacbcad	TRUE
bdcccaaadbcacbaa	TRUE
bdcccbbdbabadddc	TRUE
cabbaddbcbaacccc	TRUE
cabbadddacbacada	TRUE
cadbcaacacccaccc	TRUE
cadbcacdacabcccd	TRUE
cbcababccaaababd	TRUE
cbcabacbaddacdcd	TRUE
ccadaadcacddbaaa	TRUE
ccadabdaacbdbcdd	TRUE
ccdacdbdddbbcdda	TRUE
ccdadaddbadcadad	TRUE
cdbdabdbcdcabdcd	TRUE
cdbdadadabbbaada	TRUE
daabcdcbbbadcdbd	TRUE
daabdaabbcadbabd	TRUE
dadbabacaacacdbc	TRUE
dadbacbadddbcbaa	TRUE
dbbdabdbaaadadca	TRUE
dbbdacdcbbdccdca	TRUE
dcabaccddabdccba	TRUE
dcabadcddcddbdbc	TRUE
dcdaaabaaddcadcd	TRUE
dcdaaadbcabbacca	TRUE
ddbbcbddaddbcbdd	TRUE
ddbbcccbdbdcbabd	TRUE
aaaaaabddadddbbc	FALSE
aaaaaadabdaddbbd	FALSE
aacbdadbbaccccac	FALSE
aacbdbaddbaaaabc	FALSE
abbabcccccdaacdd	FALSE
abbabcdbadbccaca	FALSE
abdccaabbcdabbbc	FALSE
abdcdaacbcbcabac	FALSE
accadbbbddbcabbd	FALSE
accaddabbdbbbaad	FALSE
adacdcbbbcacdada	FALSE
adacdcbcaadaddbc	FALSE
addadddabacbbaac	FALSE
addbaacacddaadba	FALSE
bacaaccbddcbaacb	FALSE
bacabacbacaddabb	FALSE
bbacdabbcccabcab	FALSE
bbacdbaadcccddab	FALSE
bbdbadacbbddadab	FALSE
bbdbadbbdcabdaab	FALSE
bccaaaddacddccdb	FALSE
bccaacaaccbccbcb	FALSE
bdabbcbdcdbdcbab	FALSE
bdabbdbacabaaadb	FALSE
bdcdacababdbcbab	FALSE
bdcdacbbadcbddab	FALSE
cabbbbbdbddddccb	FALSE
cabbbbcdaddabddb	FALSE
caddcdbbacaabcab	FALSE
caddcdbccddcabab	FALSE
cbcbaadcdadcdcdb	FALSE
cbcbabadbcdcddbb	FALSE
ccbaccdacadbcabb	FALSE
ccbacddacdcadadb	FALSE
ccddaadcdcdbcdab	FALSE
ccddabaacaaabcdb	FALSE
cdcacdaaadbadbcb	FALSE
cdcacdcadabbdaab	FALSE
daacbbbbdccbddab	FALSE
daacbcccadbdcccb	FALSE
dadbcbadcdacaadb	FALSE
dadbcbccbcbdcddb	FALSE
dbbddccbccadcadb	FALSE
dbcaabbabdccaabb	FALSE
dcacacbcacbbcddb	FALSE
dcacaccbbbdbdaab	FALSE
dccdcabcabcdbdcb	FALSE
dccdccaadbbaabab	FALSE
ddbdbabbaadccbbb	FALSE
ddbdbaccbdbdbcab	FALSE
aaaaaabddadddbbcb	TRUE
aaaaaadbdaddbbddb	TRUE
aacbddcdabaaabaab	TRUE
aaccaaadddbaaacdb	TRUE
abbaccccbaabacdab	TRUE
abbacdabdadddcdab	TRUE
abdccbcdabdbddccb	TRUE
abdcccdbacbbacbdb	TRUE
accbdcabadbabacdb	TRUE
accbdccdabababdab	TRUE
adadbaaddabcdccdb	TRUE
adadbabbadaaaaaab	TRUE
addbbabdabcdabccb	TRUE
addbbbbcddddaddcb	TRUE
babddbaabdddcabbc	TRUE
babddbadbdaabddba	TRUE
bbabcddbcbaabcbcc	TRUE
bbabdaaadbcccccaa	TRUE
bbdaaddcadadcccdd	TRUE
bbdabcadadaabdada	TRUE
bcbdacadcbcbcbada	TRUE
bcbdacccadadadcbd	TRUE
bdababacaabadbdac	TRUE
bdababbbcbbcbbaad	TRUE
bdcdcbbccbdbdbbcc	TRUE
bdcdcbcaaacbaadca	TRUE
cabbccddcdcaabdbc	TRUE
cabcaadddaddabbbd	TRUE
cbaaaddbcbadbdaaa	TRUE
cbaabacadcdbbaabc	TRUE
cbcdaabcddaddbcac	TRUE
cbcdacdacabbacdac	TRUE
ccbbacdacbdadccca	TRUE
ccbbadbbcaabdbdda	TRUE
ccdccaacbadccdada	TRUE
ccdccaaccaccbbaad	TRUE
cdcacadbadcdddcba	TRUE
cdcacbdbddaaaabbc	TRUE
daadaddcaacbabcaa	TRUE
daadaddcadcbbaaba	TRUE
dadacdcabadbdcbac	TRUE
dadadcccacbbabbda	TRUE
dbbccdddaadddcadc	TRUE
dbbcdaaaaabcdaacc	TRUE
dcabbadbbbbccbdbc	TRUE
dcabbbbccbbcabbad	TRUE
dccdcabacbcbacbdd	TRUE
dccdcbcadcbbcaddd	TRUE
ddbadbaaccdaaaadc	TRUE
ddbadcaabacbaaadd	TRUE
aaaaacabadbdacabd	FALSE
aaaaadbccabcddadc	FALSE
aaccabddcddaacdca	FALSE
aaccaccacdacadcdc	FALSE
abbaabdbcddccbaaa	FALSE
abbaacbaaaacddbca	FALSE
abdbacbdbbbadcdda	FALSE
abdbaccbdbcaccccc	FALSE
acbbdbcacccababaa	FALSE
acbbdbcadaaaadcdc	FALSE
acdccddabcdbcbaaa	FALSE
acdcdacbcbdabbaad	FALSE
adcbacccbaadabccc	FALSE
adcbacdabbbdbcbca	FALSE
baacddbabcaacbdbb	FALSE
baadaacddacbacbab	FALSE
badbbbdcccccdbdab	FALSE
badbbbddcddbcaddb	FALSE
bbcaacaabacccdcbb	FALSE
bbcaaccdccbddbccb	FALSE
bcacddcbabacbcbbb	FALSE
bcacdddbddbcaddcb	FALSE
bcdcbcadcbcdcccbb	FALSE
bcdccabdabdbcccbb	FALSE
bdcaccdabaddbdccb	FALSE
bdcadbaaabddcaacb	FALSE
caadaadadbbccdacb	FALSE
caadabcdcbbbdabdb	FALSE
cadcacdadcaadaaab	FALSE
cadcadbcdcbdbdcab	FALSE
cbbddcdcbbacdccab	FALSE
cbcaabbcacbbcddab	FALSE
ccabdbccccababadb	FALSE
ccabdbcdacbcdaaab	FALSE
ccdbbcabdbacccddb	FALSE
ccdbbcacdaadcbdab	FALSE
cdbdcdaaddbacacdb	FALSE
cdbdcdbabdaddccdb	FALSE
daacaacbdacabbdab	FALSE
daacaadbbccdbabcb	FALSE
dadbbaaabbccbbcbb	FALSE
dadbbbabdcbcbddcb	FALSE
dbbdbdddbaddabdcb	FALSE
dbbdcabdbddaacbdb	FALSE
dcabbaacdcaaccddb	FALSE
dcabbbabdbccabbbb	FALSE
dccddbdcdccbcabcb	FALSE
dccddcccccadacddb	FALSE
ddbbdadbddaadbccb	FALSE
ddbbdcbadaaabdcab	FALSE
aaaaaabbbdbdbcddcb	TRUE
aaaaabbcdddccbbccb	TRUE
aacbdacdaccbacdabb	TRUE
aacbdcbababbcdbacb	TRUE
abbadcdabbddccbddb	TRUE
abbadcdbccdbbacacb	TRUE
abdcaadadbcdaddabb	TRUE
abdcaddabbbbdadabb	TRUE
accbbcabdaccaddccb	TRUE
accbbccdcbbbaaaaab	TRUE
adbaadcabbdddbabcb	TRUE
adbabbadbdccbcbadb	TRUE
addcadabccadcdaabb	TRUE
addcadacbbbaacbbcb	TRUE
bacbcbabbcbbbaddbd	TRUE
bacbcdbcabcdcbddac	TRUE
bbbaadcdccbcdbcdad	TRUE
bbbabacddacabdbacc	TRUE
bbdccbddbcdadabdba	TRUE
bbdcccbbbbbbdcbcaa	TRUE
bccabcddcddbcbcdcd	TRUE
bccacaabcbcaacdbad	TRUE
bdadaabaaddbdcadad	TRUE
bdadaccdcccccbacca	TRUE
bdcddaacbdadbdccdc	TRUE
bdcddacbcacabdacda	TRUE
cabbbacbddabcdacad	TRUE
cabbbcdaadbabaadaa	TRUE
cadcdabaddcabcaccc	TRUE
cadcdbbcdbcabcbbaa	TRUE
cbccccdbdcabdaabad	TRUE
cbccdabcdbabadaadc	TRUE
ccbaacbdcddccaacaa	TRUE
ccbaacccddbbddcccd	TRUE
ccdcacbbabbdbbbabd	TRUE
ccdcadabbcccacddaa	TRUE
cdcaddcdbcbabbaddd	TRUE
cdcbaabbbcaddacbad	TRUE
dababadaccaccbaadd	TRUE
dababadadabdacccad	TRUE
dadbcccddadbbabdcd	TRUE
dadbcdaccaddbacbda	TRUE
dbcacabddcbcbcaaca	TRUE
dbcacbacbbdabdcdcc	TRUE
dcaccccccabbcacdcc	TRUE
dcaccdccdaaadddbbc	TRUE
dcdacbacabdacccbac	TRUE
dcdacbbacbbcaccbdd	TRUE
ddbbcbbdaacdadacac	TRUE
ddbbcbdcdbddbacbdc	TRUE
aaaaaabbbdbdbcddcc	FALSE
aaaaabbcdddccbbccd	FALSE
aacbdacdaccbacdabc	FALSE
aacbdcbababbcdbacc	FALSE
abbadcdabbddccbddd	FALSE
abbadcdbccdbbacacc	FALSE
abdcaadadbcdaddabd	FALSE
abdcaddabbbbdadabd	FALSE
accbbcabdaccaddcca	FALSE
accbbccdcbbbaaaaac	FALSE
adbaadcabbdddbabcc	FALSE
adbabbadbdccbcbada	FALSE
addcadabccadcdaabc	FALSE
addcadacbbbaacbbcc	FALSE
bacbcbabbcbbbaddbb	FALSE
bacbcdbcabcdcbddab	FALSE
bbbaadcdccbcdbcdab	FALSE
bbbabacddacabdbacb	FALSE
bbdccbddbcdadabdbb	FALSE
bbdcccbbbbbbdcbcab	FALSE
bccabcddcddbcbcdcb	FALSE
bccacaabcbcaacdbab	FALSE
bdadaabaaddbdcadab	FALSE
bdadaccdcccccbaccb	FALSE
bdcddaacbdadbdccdb	FALSE
bdcddacbcacabdacdb	FALSE
cabbbacbddabcdacab	FALSE
cabbbcdaadbabaadab	FALSE
cadcdabaddcabcaccb	FALSE
cadcdbbcdbcabcbbab	FALSE
cbccccdbdcabdaabab	FALSE
cbccdabcdbabadaadb	FALSE
ccbaacbdcddccaacab	FALSE
ccbaacccddbbddcccb	FALSE
ccdcacbbabbdbbbabb	FALSE
ccdcadabbcccacddab	FALSE
cdcaddcdbcbabbaddb	FALSE
cdcbaabbbcaddacbab	FALSE
dababadaccaccbaadb	FALSE
dababadadabdacccab	FALSE
dadbcccddadbbabdcb	FALSE
dadbcdaccaddbacbdb	FALSE
dbcacabddcbcbcaacb	FALSE
dbcacbacbbdabdcdcb	FALSE
dcaccccccabbcacdcb	FALSE
dcaccdccdaaadddbbb	FALSE
dcdacbacabdacccbab	FALSE
dcdacbbacbbcaccbdb	FALSE
ddbbcbbdaacdadacab	FALSE
ddbbcbdcdbddbacbdb	FALSE
aaaaaacacdbcdcbdbcb	TRUE
aaaaababdbbcbdabcdb	TRUE
aaccabaddbdbbadcdcb	TRUE
aaccacbdbaaccccbbab	TRUE
abbaccbaddaabbccadb	TRUE
abbacdcdadbcabbaccb	TRUE
abdcdbacdcbbdcaaddb	TRUE
abdcdbbbbadbacdacbb	TRUE
accbdcadbbacaacbddb	TRUE
accbdcbbbdbabdcdabb	TRUE
adbacaddbcaccbddacb	TRUE
adbacbcbbcbbcaaadcb	TRUE
addddbcdbdccdbcdbab	TRUE
addddcbcbbddccccacb	TRUE
baccbadbaddbacacbba	TRUE
baccbddadccaaddddcc	TRUE
bbbbbabdcdadcccacda	TRUE
bbbbbbddacaacadddbc	TRUE
bbdcdcbdccbddaaddad	TRUE
bbdcddbabcadcbccdcd	TRUE
bccabbbcabdccabdabc	TRUE
bccabcdaacacbdadcba	TRUE
bdaccddcddbcbbdabcd	TRUE
bdacdaabbccaabcdbac	TRUE
bddbaaddacdbccabaca	TRUE
bddbacddbcdcdccdddc	TRUE
cabdadccbacbbaabaad	TRUE
cabdbacbbbbaabcbbdd	TRUE
cbabbdacddbccbccbac	TRUE
cbabcbcdcdadbbdaaaa	TRUE
cbcdadcdaabcbadcbcc	TRUE
cbcdbccaabddabdbacc	TRUE
ccbbdcccaaaddaddddc	TRUE
ccbbdddcaddbdbbcaca	TRUE
cdaabcdcabaddbbadbc	TRUE
cdaabdbdbbacbcaaccc	TRUE
cdccbaabcdbabbccbbd	TRUE
cdccbaadbbdbdacaaac	TRUE
dabaccacacbbdddabbd	TRUE
dabaccddabcacbacbda	TRUE
dadcccdbadbbbabaabd	TRUE
dadcccdcaaddacccbca	TRUE
dbbdbdcadbbcacacdda	TRUE
dbbdbdcadbcacbdccdc	TRUE
dcabadbdcbcdbdaccbc	TRUE
dcabadccbbaaadbdbbc	TRUE
dccccddabbaabaabcca	TRUE
dccccdddbacbacbcadc	TRUE
ddbccbbbbcacdcbdbad	TRUE
ddbccbcadadbadbbcda	TRUE
aaaaabdacbbcaacaabd	FALSE
aaaaadbacbbcabdddba	FALSE
aaccbbdbcbadcdcbbaa	FALSE
aaccbcaaccdcaaddabc	FALSE
abadddaccddcaadccba	FALSE
abaddddbadcdadcbbdd	FALSE
abdcbcdabbadbaaddda	FALSE
abdcbcdcbbadcdacdba	FALSE
accbabababdacbacacc	FALSE
accbababacccdacbcca	FALSE
adadccccadcbbacdcac	FALSE
adadccdcbccbabbddba	FALSE
addbbdcccaaadbabcdc	FALSE
addbbddccbdacdabaac	FALSE
babdacccacadcbbaabb	FALSE
babdadabcbbdabaddcb	FALSE
bbabcaaadabbcaabcbb	FALSE
bbabcaacdccdacdcabb	FALSE
bbdabbcdcacaccaaccb	FALSE
bbdabbdaacadbcbaddb	FALSE
bcbccabdbcbdbbabbcb	FALSE
bcbccacddacbabcccab	FALSE
bcddddbdcbadbadbbcb	FALSE
bcddddddacaadcddddb	FALSE
bdccbdcabadccabccab	FALSE
bdcccadcdbcddbcbbbb	FALSE
caadbdbbbdcdbbcdbdb	FALSE
caadccbbddadacaaacb	FALSE
cadbccdadacddabccdb	FALSE
cadbcddccbacaacbacb	FALSE
cbcaacaccddbbbdbcbb	FALSE
cbcaaccccaccbdcdbbb	FALSE
ccacdbcddadbadccbdb	FALSE
ccacdbdaababcacdbcb	FALSE
ccdaadccadacbadaadb	FALSE
ccdabacbcabbcdbcdab	FALSE
cdbcdcdcbcbbdadbbdb	FALSE
cdbcdcdccdbaaccdbcb	FALSE
daaaddbaddbacaaddcb	FALSE
daabaaacccdcbdaddbb	FALSE
daccccadcdcaddcbbbb	FALSE
dacccdaccadcddccbab	FALSE
dbbbccddacadadddcbb	FALSE
dbbbcdbcdcdaaadccbb	FALSE
dcabcdcdbdddabdbbdb	FALSE
dcabcdcdccadbadabbb	FALSE
dcccdcdabdabdbbbdcb	FALSE
dccdaabdabbdacbdbdb	FALSE
ddbadcdcccbdddbcdab	FALSE
ddbaddbdaaddbababbb	FALSE
