aaaaaadacb	TRUE
aaaaabccda	TRUE
aacccbddcc	TRUE
aacccdadab	TRUE
abadcacdad	TRUE
abadcadcdc	TRUE
abdddadaca	TRUE
abdddadadc	TRUE
acccbcdaaa	TRUE
acccbcdaca	TRUE
adbcacdacd	TRUE
adbcacdacd	TRUE
adddadcdba	TRUE
adddbaadcc	TRUE
baccadaccc	TRUE
baccadccda	TRUE
badddcaaca	TRUE
badddcaadd	TRUE
bccaadcacd	TRUE
bccaadcdaa	TRUE
bcdccacada	TRUE
bcdccadcac	TRUE
bdadcdaacd	TRUE
bdadcdadac	TRUE
bddaddacdd	TRUE
bddaddadcc	TRUE
cabaadcdaa	TRUE
cabaaddccc	TRUE
cadcadcadb	TRUE
cadcadcdba	TRUE
cbccccdcaa	TRUE
cbcccdaaad	TRUE
ccacbcddad	TRUE
ccacbdacad	TRUE
ccdaacddab	TRUE
ccdaaddaba	TRUE
cdbdadaaca	TRUE
cdbdadcadd	TRUE
daabdadcdd	TRUE
daabddcdcc	TRUE
dadaaadacb	TRUE
dadaabaaaa	TRUE
dbcaccadaa	TRUE
dbcaccadac	TRUE
dcabacdada	TRUE
dcabaddcdc	TRUE
dcdaaabcda	TRUE
dcdaabaccd	TRUE
ddbadcccad	TRUE
ddbadccccd	TRUE
aaaaaadaca	FALSE
aaaaabbbdb	FALSE
aacccbdddb	FALSE
aacccdadad	FALSE
abadddbaab	FALSE
abadddcccb	FALSE
abddcbaaad	FALSE
abddcbbcbc	FALSE
acccbccaab	FALSE
acccbcdcab	FALSE
adbbddcbdb	FALSE
adbcaacbcb	FALSE
adddadcdbb	FALSE
adddbaaacb	FALSE
baccadbacc	FALSE
baccaddbca	FALSE
bbbbabacdc	FALSE
bbbbabdabc	FALSE
bbdcaadccd	FALSE
bbdcabcaab	FALSE
bcbdbbbaad	FALSE
bcbdbccdab	FALSE
bdaacbdcca	FALSE
bdaacccaab	FALSE
bdcccdccab	FALSE
bdccdaabbb	FALSE
cababadcab	FALSE
cababbadbc	FALSE
cadcadcada	FALSE
cadcadcdbb	FALSE
cbcacadbaa	FALSE
cbcacbcddd	FALSE
ccacbcdcbd	FALSE
ccacbdabad	FALSE
ccdaacddac	FALSE
ccdaaddabb	FALSE
cdbcdcdaab	FALSE
cdbcdcdddb	FALSE
daabcbbcdd	FALSE
daabcbcddd	FALSE
dadaaadacc	FALSE
dadaababaa	FALSE
dbbbcdacbb	FALSE
dbbbcdbaab	FALSE
dcabbaacdb	FALSE
dcabbadcbc	FALSE
dcdaaabbda	FALSE
dcdaabbccd	FALSE
ddbbbdbcac	FALSE
ddbbbddbaa	FALSE
aaaaaadacbc	TRUE
aaaaabcdacd	TRUE
aaccabdddda	TRUE
aaccbadcadd	TRUE
abadcccdcda	TRUE
abadcdaaddd	TRUE
abdddadaddc	TRUE
abdddcadaac	TRUE
acccccaaabc	TRUE
acccdbdcada	TRUE
adbaddcadcd	TRUE
adbaddccaaa	TRUE
adddabaaadd	TRUE
adddabddaaa	TRUE
bacadcadaac	TRUE
bacadccadca	TRUE
baddcacddda	TRUE
baddccaacaa	TRUE
bccaadcddcc	TRUE
bccaaddaaaa	TRUE
bcddaaaaacc	TRUE
bcddaaadddc	TRUE
bdcacacddaa	TRUE
bdcacadacca	TRUE
bddcacaaccd	TRUE
bddcacaadca	TRUE
cabcadaddad	TRUE
cabcadcaaca	TRUE
caddbcccaca	TRUE
caddbddccdd	TRUE
cbccccaacca	TRUE
cbccccacdcd	TRUE
ccabdacdacd	TRUE
ccabddcdadd	TRUE
cccddcdaadb	TRUE
cccdddacddb	TRUE
cdbddacadca	TRUE
cdbddcacaac	TRUE
daacbaccddd	TRUE
daacbadaada	TRUE
dadaacbaddc	TRUE
dadaadabaac	TRUE
dbcacdacaca	TRUE
dbcacdaccad	TRUE
dcaadadcaab	TRUE
dcaadbadcaa	TRUE
dcccdcccddb	TRUE
dcccdddbccd	TRUE
ddbaccddaac	TRUE
ddbacdacaca	TRUE
aaaaaadacbb	FALSE
aaaaabbdbbd	FALSE
aaccabddddb	FALSE
aaccbadbbdd	FALSE
abbabdcbcca	FALSE
abbaccdaacb	FALSE
abddbddbcab	FALSE
abddcacbdaa	FALSE
acccccaaabb	FALSE
acccdbdcbdb	FALSE
adbbbbbbaba	FALSE
adbbbcabbba	FALSE
adddabbcdca	FALSE
adddabcdaab	FALSE
bacbaccdaac	FALSE
bacbaccddba	FALSE
bbacdbbacbc	FALSE
bbacdbbbcab	FALSE
bbdbcacadda	FALSE
bbdbcbcabdd	FALSE
bcbddbaaacc	FALSE
bccaabaddcc	FALSE
bdabcbbccbc	FALSE
bdabcbccddd	FALSE
bdcdcaccadb	FALSE
bdcdcbcdabc	FALSE
cabbdbdbbbc	FALSE
cabbdbdbbcd	FALSE
caddbcbbaca	FALSE
caddbddcbcd	FALSE
cbcabdddcbd	FALSE
cbcacabccba	FALSE
ccabcdbdbda	FALSE
ccabdcccdbc	FALSE
cccddcdaada	FALSE
cccdddacddd	FALSE
cdbddaaabcb	FALSE
cdbddaacccb	FALSE
daacbacdcdb	FALSE
daacbadcdab	FALSE
dadaacbbddb	FALSE
dadaadabaab	FALSE
dbbccaabdcb	FALSE
dbbccadadad	FALSE
dcaadadcaaa	FALSE
dcaadbadcab	FALSE
dcccdcccddc	FALSE
dcccdddbcbd	FALSE
ddbadaadbcd	FALSE
ddbadaccbda	FALSE
aaaaaaaabaaa	TRUE
aaaaaadabaaa	TRUE
aacbddaadcdc	TRUE
aacbddcccdaa	TRUE
abaddccaccdd	TRUE
abaddcdcdaaa	TRUE
abddcaacdada	TRUE
abddcacacada	TRUE
accaccbcddda	TRUE
accacdbdaccd	TRUE
adadadcbdaaa	TRUE
adadbadcddac	TRUE
addcbdcdadca	TRUE
addcbddaddad	TRUE
bacaaaaadadd	TRUE
bacaaacddcad	TRUE
badcadaaacaa	TRUE
badcadaacdac	TRUE
bcadccacdcac	TRUE
bcadccacdcca	TRUE
bcdacadaaccd	TRUE
bcdacadcaaaa	TRUE
bdacdcdadacd	TRUE
bdacdcdcaacc	TRUE
bddacddacaaa	TRUE
bddacddcadac	TRUE
cabaadcddaad	TRUE
cabaaddaaddc	TRUE
cadcdcddaccb	TRUE
cadcddbaadaa	TRUE
cbcccddaacdc	TRUE
cbccdaaacdac	TRUE
ccaddabaccca	TRUE
ccaddbdcdadd	TRUE
ccdbcacacaac	TRUE
ccdbcacacddd	TRUE
cdbdddaadcca	TRUE
cdbdddadaadd	TRUE
daadbadcadac	TRUE
daadbdaacacd	TRUE
dadcbadaaacd	TRUE
dadcbcaddacd	TRUE
dbccdcacacaa	TRUE
dbccdcaccaac	TRUE
dcaccccacdba	TRUE
dcaccccdbdac	TRUE
dcdadadaaccb	TRUE
dcdadcbcdadc	TRUE
ddbcadaadccc	TRUE
ddbcadaddcaa	TRUE
aaaaaaaababa	FALSE
aaaaaadabaab	FALSE
aacbcdaaddab	FALSE
aacbdabccddc	FALSE
abbacadcdbcb	FALSE
abbacadddcdc	FALSE
abdcdcbddddd	FALSE
abdcdccacddb	FALSE
accaccbbdcda	FALSE
accacdbcacbc	FALSE
adadadcbdaab	FALSE
adadbadcddab	FALSE
addcbccdcbdb	FALSE
addcbdbaddad	FALSE
babdabcbcacd	FALSE
babdacdbdacc	FALSE
bbabcaacdbaa	FALSE
bbabcaccdbda	FALSE
bbcdabadabbb	FALSE
bbcdabcdbcda	FALSE
bcbbcbbbddad	FALSE
bcbbccabddda	FALSE
bcddcbbaabbb	FALSE
bcddcbcdcaaa	FALSE
bdcbcbadddcc	FALSE
bdcbcbdaaddc	FALSE
cababbdbbdad	FALSE
cababcbadaad	FALSE
cadcdcddacca	FALSE
cadcddbaadab	FALSE
cbcabcadccba	FALSE
cbcabcddbcdd	FALSE
ccaddabbcbcb	FALSE
ccaddbccdbdc	FALSE
ccdbbdadaaca	FALSE
ccdbbddbbcdc	FALSE
cdbddbbbcbcc	FALSE
cdbddbdbcacb	FALSE
daadbbdbadbc	FALSE
daadbdacacab	FALSE
dadcbadbabbc	FALSE
dadcbbaddbbd	FALSE
dbcaccaccbcb	FALSE
dbcaccddaadb	FALSE
dcaccccacdbb	FALSE
dcaccccdbdab	FALSE
dcdadadaacca	FALSE
dcdadcbbdacb	FALSE
ddbbcacacdab	FALSE
ddbbcbcacbdc	FALSE
aaaaaaaabaaaa	TRUE
aaaaaadbaaacd	TRUE
aacbdcdccaaaa	TRUE
aacbddcaaddad	TRUE
abadcaaddcdca	TRUE
abadcaccaaadd	TRUE
abddacadccccc	TRUE
abddacdadcdad	TRUE
accbaadcdaacc	TRUE
accbaccdaaada	TRUE
adadbaaadadac	TRUE
adadbaadcaadc	TRUE
addcbddaadcda	TRUE
addccadccdbad	TRUE
bacadaaaadcdd	TRUE
bacadacccadda	TRUE
badcdcdcdccdd	TRUE
badcdcdcddaac	TRUE
bccacacaddcca	TRUE
bccacaccddddc	TRUE
bcdccccacdadc	TRUE
bcdccccadaddc	TRUE
bdadcaccadcac	TRUE
bdadcacdaddca	TRUE
bddadaccaccad	TRUE
bddadacdcddca	TRUE
cabaacacadccd	TRUE
cabaacdaaacaa	TRUE
cadcacdbccdda	TRUE
cadcbcddcaccd	TRUE
cbcddcdaaacad	TRUE
cbcddcdacdada	TRUE
ccbaaddcddcdc	TRUE
ccbaadddcadca	TRUE
ccdcaabdccccd	TRUE
ccdcabdddddaa	TRUE
cdcabcdaaaaca	TRUE
cdcabdccdddaa	TRUE
daadadbcdaaaa	TRUE
daadaddbddccd	TRUE
dadbcadaadaac	TRUE
dadbcaddaaddc	TRUE
dbcaadcdcdaca	TRUE
dbcaaddacaacd	TRUE
dcaacbcddcddc	TRUE
dcaacdaacbacc	TRUE
dcccdcbadaccd	TRUE
dcccddadacabd	TRUE
ddbadcacddacd	TRUE
ddbadcddccadc	TRUE
aaaaaadcdbddb	FALSE
aaaaabdddbadb	FALSE
aaccaabcbbdba	FALSE
aaccaadbbdbbb	FALSE
abbaacdbaaacd	FALSE
abbaacdcbcbdc	FALSE
abdcdabbdcabd	FALSE
abdcdcbdababc	FALSE
accaadaaccaac	FALSE
accaadbcccbca	FALSE
adacdbdbdbddc	FALSE
adacddbccdadb	FALSE
addbcbdabcbdc	FALSE
addbccdbcbbaa	FALSE
babddadaaacbc	FALSE
babddadaacacd	FALSE
bbacdddddbabd	FALSE
bbadaaadadacc	FALSE
bbdbbdadcdbbc	FALSE
bbdbbdccabdaa	FALSE
bcbddcddcdaab	FALSE
bcbdddcdaacbb	FALSE
bdadabbbcaccc	FALSE
bdadaddcdcadb	FALSE
bddaccbcabdca	FALSE
bddadbcbccadd	FALSE
cabdbaccbabcb	FALSE
cabdbadccbaab	FALSE
cbaadcdacaadb	FALSE
cbaaddcdcdbdb	FALSE
cbcdacadddccb	FALSE
cbcdaccbaacba	FALSE
ccbbabdccabbb	FALSE
ccbbbbaacbcad	FALSE
ccddaccaccbbc	FALSE
ccddadbadbcad	FALSE
cdcbdabbcdadb	FALSE
cdcbdadabacbd	FALSE
dabadbacdccad	FALSE
dabadbccbcdac	FALSE
daddbbddbacad	FALSE
daddbcaccadbd	FALSE
dbcbaddbadbab	FALSE
dbcbbaddbaccc	FALSE
dcadaaaaddada	FALSE
dcadaaddcccdd	FALSE
dcdacbdadaddb	FALSE
dcdacbdbdbbab	FALSE
ddbcbcdacdbbd	FALSE
ddbcbdbddabbc	FALSE
aaaaaadcdbddca	TRUE
aaaaabddcadaaa	TRUE
aaccbaccaacccd	TRUE
aaccbadccdadad	TRUE
abadcacadaddad	TRUE
abadcadacaadda	TRUE
abddaccacccdcd	TRUE
abddaccccdadaa	TRUE
accaacddbaaada	TRUE
accaadcbdadadd	TRUE
adacbdaccddacd	TRUE
adacbdadcdccdc	TRUE
addabdaadddcda	TRUE
addabdcacddddd	TRUE
bacacaadcacccd	TRUE
bacacacaacccda	TRUE
baddadaccaddda	TRUE
baddadadaaacad	TRUE
bccaadaacdcdcd	TRUE
bccaadaadccdaa	TRUE
bcdccdaaaaaaad	TRUE
bcdccdadaddadc	TRUE
bdcacdaccdcdad	TRUE
bdcacdaddadccc	TRUE
bddcdadadcacda	TRUE
bddcdadccacdac	TRUE
cabdcaacadcdcc	TRUE
cabdcaccaaadcd	TRUE
cbaacdadccaada	TRUE
cbaacdcacdddac	TRUE
cbdaadccacaccc	TRUE
cbdaadccdcdacc	TRUE
ccbcacaccdcada	TRUE
ccbcacccdcacdc	TRUE
ccddcdabcdcaca	TRUE
ccdddbdcdcacaa	TRUE
cdcbdcdccddadd	TRUE
cdcbdcdcddadac	TRUE
daadccaddbaccc	TRUE
daaddaacccbccc	TRUE
dadadddaaaccba	TRUE
dadbacaaddddad	TRUE
dbcccaaccaacda	TRUE
dbcccacadcddda	TRUE
dcabcaacaadadc	TRUE
dcabcaadcccaca	TRUE
dccdbdaddacaaa	TRUE
dccdbdcadaddcd	TRUE
ddbcccddadcccc	TRUE
ddbcdaaacadcda	TRUE
aaaaaacacbbbbd	FALSE
aaaaaacdadabcb	FALSE
aaccbcbcabaada	FALSE
aaccbdbcbddbbb	FALSE
abbabcdacccbbd	FALSE
abbabdabbcaabd	FALSE
abdcbdbcdcabbb	FALSE
abdcbdbdcdddba	FALSE
accacdbaacbdbc	FALSE
accadbabaccddb	FALSE
adadbdbbcacdcd	FALSE
adadcaccbdbdaa	FALSE
addccccbadbcdb	FALSE
addcccccabdabd	FALSE
babdaadcdabcbb	FALSE
babdaaddadddda	FALSE
bbabaaacbaaccc	FALSE
bbabaaaddcbabd	FALSE
bbcccdcbcbbcda	FALSE
bbcccdcdcbcaac	FALSE
bcbaccabcdacbb	FALSE
bcbacccbcbddda	FALSE
bdaabcaacadcda	FALSE
bdaabcbaabbcdb	FALSE
bdccabaaddaccd	FALSE
bdccabbaacdaab	FALSE
cabadddcdcaddb	FALSE
cabaddddccaccb	FALSE
cbaacbacaadcac	FALSE
cbaacbacabcaaa	FALSE
cbccbcdadccbdb	FALSE
cbccbdcbaccaac	FALSE
ccbacddbccacdd	FALSE
ccbacdddbabcbb	FALSE
ccddcdcccabcab	FALSE
ccddcdddadcaca	FALSE
cdccdbcdbdbbda	FALSE
cdccdccbaabdcd	FALSE
daadcabcdbacbd	FALSE
daadcadadcddbb	FALSE
dadbdadbbbdbdc	FALSE
dadbdbddcadcbd	FALSE
dbbdbacdbbbacc	FALSE
dbbdbccbdbdaac	FALSE
dcabbbccaaddbb	FALSE
dcabbcbacbdccb	FALSE
dccdaacabbabcd	FALSE
dccdabacacccba	FALSE
ddbbacccbccbaa	FALSE
ddbbbaabdcdabc	FALSE
aaaaaacacbccada	TRUE
aaaaaacddabcaca	TRUE
aacccaddcddaccb	TRUE
aacccbcdddaacda	TRUE
abaddcccadadaca	TRUE
abaddcdaaddadac	TRUE
abddcadaacadadc	TRUE
abddcadacdccddc	TRUE
accaddaaacadcab	TRUE
accbaaaacccaaac	TRUE
adaddabadaddadc	TRUE
adaddaccacaaacb	TRUE
addbdcadaacddaa	TRUE
addbdcdaacccadd	TRUE
bacacdacaacacdd	TRUE
bacacdaccadacac	TRUE
badccccdadaccda	TRUE
badcccdaaddadcd	TRUE
bcadacdadcadddd	TRUE
bcadacddacacaad	TRUE
bcdacaaaacdaaaa	TRUE
bcdacaacadccacc	TRUE
bdacddcdcaddadc	TRUE
bdacdddadcccaad	TRUE
bddacdcdcaddacd	TRUE
bddacdcddacdaca	TRUE
cabaaaaddcccacd	TRUE
cabaaacaccccdaa	TRUE
cadcadbaadccadc	TRUE
cadcadbadaacdad	TRUE
cbcdcaaaadaacad	TRUE
cbcdcaaacdacadc	TRUE
ccaddabdcccadcd	TRUE
ccaddbdccdaaddd	TRUE
ccddbacdaaaddac	TRUE
ccddbcacdaacdad	TRUE
cdcbadcccadadcd	TRUE
cdcbadcddaaaadd	TRUE
daaddbacaadcdad	TRUE
daaddcdcdbcddcd	TRUE
dadbddacdcacadd	TRUE
dadbddadcdaaddd	TRUE
dbcadcccdcccdcd	TRUE
dbcaddadaacadaa	TRUE
dcabcacdcaaccca	TRUE
dcabccdaacdcaaa	TRUE
dcdadaccbcadaad	TRUE
dcdadadbadcacac	TRUE
ddbdaaddcdacdac	TRUE
ddbdacaacacdcaa	TRUE
aaaaaabcaadbaad	FALSE
aaaaaadddcbbacd	FALSE
aaccacdcadbbcbb	FALSE
aaccadbaaadaacb	FALSE
abbacdbbbbaabdd	FALSE
abbacdcbdadbdca	FALSE
abdccdbcadddddb	FALSE
abdcdaabdbcabda	FALSE
accbdbbbdadcccc	FALSE
accbdcaabcdabda	FALSE
adbadddbddbaacd	FALSE
adbbaaacbcadcdc	FALSE
adddacddcabbbba	FALSE
adddadadbdddacb	FALSE
bacbdccddbbccbc	FALSE
bacbddcabbcbdab	FALSE
bbbaaddbbbadccb	FALSE
bbbaadddbccdccb	FALSE
bbdccbcabcadbbc	FALSE
bbdccbcccccbadd	FALSE
bccbaadadacbadc	FALSE
bccbacdbabbdddc	FALSE
bdadcbdcdbdcbad	FALSE
bdadccbdddcddca	FALSE
bddbbcdbacabbbd	FALSE
bddbbcddbcdbbbc	FALSE
cabcbdaddcbcdac	FALSE
cabcbdbcbddbbcb	FALSE
caddbabbbbbbcdb	FALSE
caddbbacaadbacc	FALSE
cbcccddaadcdbda	FALSE
cbccdadcbaccbba	FALSE
ccaddddccadcccd	FALSE
ccbaabaddcbbdbc	FALSE
ccdbbddaddcacbd	FALSE
ccdbcaadcdcbdbd	FALSE
cdcacbacbabbaad	FALSE
cdcacbbbbaaccbb	FALSE
daabbabdacdacba	FALSE
daabbbdbbcbdbdc	FALSE
dacdbdbdccbdcac	FALSE
dacdccbbdcbabda	FALSE
dbbbdddccabbabd	FALSE
dbbcaababaabcba	FALSE
dcabbdbadbdbabd	FALSE
dcabcbddaaaccbd	FALSE
dcccdddcccbcbbb	FALSE
dccdabcdbddbabd	FALSE
ddbbadaccbbdbaa	FALSE
ddbbadbaddcdadd	FALSE
aaaaaabcaadcaadc	TRUE
aaaaaaddcbaadddd	TRUE
aacccabdaacacdaa	TRUE
aacccacdbddadadc	TRUE
abadccaacaddccdd	TRUE
abadccdacccdcccd	TRUE
abddccdddaacdacd	TRUE
abddcdcaacddddad	TRUE
accbdaaacdcddadd	TRUE
accbdaadacacaddd	TRUE
adbaccacdddccdaa	TRUE
adbaccccdadadadd	TRUE
adddbadaccadcdcc	TRUE
adddbcadadaaaaca	TRUE
bacadcdccdadccac	TRUE
bacaddacdcaaccdc	TRUE
badcddcdcdccaddd	TRUE
baddaaaaddadaadc	TRUE
bcadddaadacaaddc	TRUE
bcadddaccdddccad	TRUE
bcdcdaddddcdacda	TRUE
bcdcdcaacdddcdad	TRUE
bdcaaaaaadacadda	TRUE
bdcaaaadadaccddc	TRUE
bddcdccddcdaacdc	TRUE
bddcddadcddadaaa	TRUE
cabdadacddccadca	TRUE
cabdadadcadcdcac	TRUE
cbaadcaacadaacad	TRUE
cbaadccadcdcddaa	TRUE
cbdacdcddacdcadc	TRUE
cbdacddacddaacaa	TRUE
ccbccdcddcaccddc	TRUE
ccbcdaaaaaacadaa	TRUE
cdaaaaaadacddcab	TRUE
cdaaaacbcadcacdd	TRUE
cdcaccadccadcdba	TRUE
cdcadaabaccddaaa	TRUE
daabaadaddaaacca	TRUE
daabaadccacdcaaa	TRUE
dadaacbdaccdadcd	TRUE
dadaacddbdadccac	TRUE
dbcadaaaacaddddd	TRUE
dbcadaaacaccccaa	TRUE
dcaacaabaaddaccd	TRUE
dcaacbaaaaadcaca	TRUE
dcccaadcddcccaab	TRUE
dcccacbdddaaadac	TRUE
ddbacccccaadadaa	TRUE
ddbacccdadcdaadc	TRUE
aaaaabbcaaaccaaa	FALSE
aaaabadbdcbadbaa	FALSE
aacdadcbbadddaab	FALSE
aacdbaaaadbaadcb	FALSE
abbbdcbbbaabbcaa	FALSE
abbbdcdaadaabcca	FALSE
abddbbbdadccccbb	FALSE
abddcadabdbbdbdd	FALSE
acccaabcbddcdaba	FALSE
acccabddacaacbcb	FALSE
adbaabbdacdacaac	FALSE
adbaacbcaadbbbac	FALSE
addccaccbccccabb	FALSE
addccadbbbadbbcd	FALSE
bacaaccdcddcabbb	FALSE
bacaadbbabaccdac	FALSE
bbaadbcbcbcccbbc	FALSE
bbaadcadabbbbadb	FALSE
bbccdaccdbbdadbc	FALSE
bbccdacdcbbcaddd	FALSE
bcbacbaccccdcdaa	FALSE
bcbacccacccdbbbb	FALSE
bcdcdaddaacdccab	FALSE
bcdcdbbbddacadaa	FALSE
bdcadabbdaadbaad	FALSE
bdcadaccabdaabcc	FALSE
caadbdacbcacddbb	FALSE
caadbdbbaabdbbcc	FALSE
cadcbccbddacddac	FALSE
cadcbdaaadbccdcb	FALSE
cbcadaacdcaddaab	FALSE
cbcadabbdaabcada	FALSE
ccbaaacdadadacab	FALSE
ccbaaacdbaadaacb	FALSE
ccdcababbaaabbcb	FALSE
ccdcaccdcddbccab	FALSE
cdcabbcccdbcbcbc	FALSE
cdcabbdbdaabbdcc	FALSE
daacccddbabbddcc	FALSE
daaccdbaccdbaddb	FALSE
dadacdbcbbaabcad	FALSE
dadacdcacacccabb	FALSE
dbbcdcabbdcdadac	FALSE
dbbcdcacacdcbabb	FALSE
dcaadababadadbcc	FALSE
dcaadcabddbcdcdd	FALSE
dccdbccbdbbcacdc	FALSE
dccdbdbbabdccabb	FALSE
ddbcccbcaacddcca	FALSE
ddbccdacbcacbddd	FALSE
aaaaabacaaacdaaaa	TRUE
aaaabacdcaadcaadc	TRUE
aacdabdaddaaccdcc	TRUE
aacdacbaacdcdccaa	TRUE
abcaaaaaccacaaadd	TRUE
abcaaaacaadcdacdd	TRUE
abdddccdcdcdcaddd	TRUE
abdddcdddacddcddc	TRUE
accbcdccddadcaadd	TRUE
accbcddcacaddcdda	TRUE
adadccbdadccadcda	TRUE
adadcccccddddabcd	TRUE
addcadbcaaddacccc	TRUE
addcbaaaaddaacaad	TRUE
bacadcdddcdaccdda	TRUE
bacaddacdadadaccd	TRUE
badcdaaddacdcddcd	TRUE
badcdadadcaddcaca	TRUE
bcaddddddadacaaac	TRUE
bccaaaaaddcdaddac	TRUE
bcdaddccdddaaacaa	TRUE
bcdaddcdccacaaddd	TRUE
bdadaaccadaaddccd	TRUE
bdadaadacaacdcdaa	TRUE
bddacacdcacdacdca	TRUE
bddacacdcdaccdaca	TRUE
caadcbcdccacdddcc	TRUE
caadcbdacadaaaddd	TRUE
cadcbcdaaaadcccca	TRUE
cadcbcdaaacaacdcc	TRUE
cbcccdaaaaaacddcc	TRUE
cbcccdccdcacadccc	TRUE
ccaccdbddddccccca	TRUE
ccacdbaddcaadaccc	TRUE
ccdbdccddcdddadcd	TRUE
ccdbdcdaadadccdca	TRUE
cdcacbcccddaaacda	TRUE
cdcacbdcaccdaaccd	TRUE
daacacccbdddaaadd	TRUE
daacacdcbaaddaacc	TRUE
daccccddcccccdcab	TRUE
daccdabcccaaddacd	TRUE
dbadccaacaadccadd	TRUE
dbadcccccccacdcaa	TRUE
dcaabccaacdcdadcc	TRUE
dcaabdcdacaddacaa	TRUE
dcccdaabccaddaccd	TRUE
dcccdbacdcaacacdc	TRUE
ddbacdcdccaaddcac	TRUE
ddbacdddccacdaacd	TRUE
aaaaabddcbcbdcaad	FALSE
aaaaadccddaddbccb	FALSE
aacdaaccbacaacabc	FALSE
aacdabacdadcdccdb	FALSE
abbbabbddbcbaddca	FALSE
abbbabbddcdbbbccc	FALSE
abddadcdcabbcddbc	FALSE
abddbbdcdccaabbad	FALSE
accbadbabdaacabdc	FALSE
accbbacbabbcacaaa	FALSE
adadcbacdbacbacca	FALSE
adadcbdbcbabccbdb	FALSE
addbacdbcbbacaccb	FALSE
addbadaddadbbdbbd	FALSE
babddcaadaddccaca	FALSE
babddcacbcaadcdad	FALSE
bbabbacdcdaddbdbb	FALSE
bbabbbbddbdbbdcca	FALSE
bbcdabdccadcacabb	FALSE
bbcdabddcdbdcbccc	FALSE
bcbbdabccacbaabda	FALSE
bcbbdddcbccdadaca	FALSE
bdaaaabcdbdaadbbb	FALSE
bdaaabcbdaadacbac	FALSE
bdcdadabbdbbababb	FALSE
bdcdadaccaacbcccc	FALSE
cabadcaccccddbddd	FALSE
cabadcbdabbccbabb	FALSE
cbaacbabddbbddcdd	FALSE
cbaacbdcbaadbccaa	FALSE
cbcccbbbcaacabcbd	FALSE
cbccccdddddaaabcb	FALSE
ccbadadcbdcbbaada	FALSE
ccbadbaacbcacaddc	FALSE
ccdcbcabcddbccdbd	FALSE
ccdcbcdcbbcbcccab	FALSE
cdbdcbdcdaddcdbcb	FALSE
cdbdccbcccacacdac	FALSE
daacbddabdcdaacdc	FALSE
daaccacdadbdaaacb	FALSE
dadadabbcccabcbca	FALSE
dadadadcbdbbacbba	FALSE
dbbcbcdbcadbaadca	FALSE
dbbcbddadbabaabac	FALSE
dcaabadbbbdacbbba	FALSE
dcaabbabbdbaadbca	FALSE
dccdcabcacaaaadcb	FALSE
dccdcacbbdcbdcddd	FALSE
ddbcadabccbcdddbc	FALSE
ddbcadacdddcaaabc	FALSE
aaaaaabddcccaadada	TRUE
aaaaabdaaadaacdcca	TRUE
aacadabcdaccdacaca	TRUE
aacadbdddccdcccdad	TRUE
abacdccaadaddcccaa	TRUE
abacdcccddcadccdac	TRUE
abdccdaadccdaccacd	TRUE
abdccdacdddacacaac	TRUE
accbcacaaadcadaaaa	TRUE
accbcaddcddcaccdcd	TRUE
adbacadcdacacdddca	TRUE
adbacadcddaaddddac	TRUE
addcabadccdccdddaa	TRUE
addcabddacadaaddca	TRUE
bacacaaddcacaacdaa	TRUE
bacacaadddccddcccd	TRUE
badccccccdcadcccdd	TRUE
badcccdccdcaddcadc	TRUE
bcadcdaddddcdadcdc	TRUE
bcadcdccdaccaadcda	TRUE
bcdaaddaacddaddcdc	TRUE
bcdaaddaadcaaacdda	TRUE
bdaccccadadddaccda	TRUE
bdaccccadccdaadadd	TRUE
bdcddccaddaacdcdcd	TRUE
bdcddcccdadacdddca	TRUE
caadcdbdcadacccdca	TRUE
caadcddccdbdadcdad	TRUE
caddaacbadddcadacd	TRUE
caddabacdaddcdcdaa	TRUE
cbcdcccacadccdaadd	TRUE
cbcdcccacdcaadccca	TRUE
ccbaccdaaadcccdaca	TRUE
ccbaccdacadaaddaaa	TRUE
ccdcadaccbcadadccc	TRUE
ccdcadcddcdbcdadca	TRUE
cdcadabcdaccacdddc	TRUE
cdcadadacadbadcddd	TRUE
daadbcaadaadccdcac	TRUE
daadbcccccaddcdcdc	TRUE
dadbdddcaaacdccaac	TRUE
dadcabacaadccdccdd	TRUE
dbcccaccadaddadddc	TRUE
dbcccacdaddaadaddc	TRUE
dcacacddcdcbddccad	TRUE
dcacadacaaccacdbcd	TRUE
dccddabaadaccdaadc	TRUE
dccddbddaaddcccadc	TRUE
ddbaddaaacdddddcdd	TRUE
ddbadddcddaddaacac	TRUE
aaaaacacddaaadbbbb	FALSE
aaaabcccbdcaccbdca	FALSE
aaccdddacdbbcabbaa	FALSE
aacdaaaacadbaaaaab	FALSE
abbaadaaadabbdcddb	FALSE
abbaaddcdababbbcda	FALSE
abdcadaccdadddaacb	FALSE
abdcadcdacaccdcddb	FALSE
acbddaccdabbaabdad	FALSE
acbddbcbacddcadcab	FALSE
adabaababdbacaaccb	FALSE
adabaaddaabcabadda	FALSE
adcddcbccabdacdddb	FALSE
adcdddacddacbdcadb	FALSE
babccbdccaaccbcbbd	FALSE
babcccddabaadbddaa	FALSE
bbabccbadaadbdcdca	FALSE
bbabccdcdcdaabdabc	FALSE
bbccdadbcaaadadbcb	FALSE
bbccdcbabcadabcdda	FALSE
bcbbcadcbccadbcacc	FALSE
bcbbcbcaadbbabbccd	FALSE
bdaaabdbbcdbddbdac	FALSE
bdaaadacabddbddacd	FALSE
bdccabadddcbacdaca	FALSE
bdccabcdaaadadcdca	FALSE
cabacbaababdbcaaaa	FALSE
cabaccbaabdbcdcabc	FALSE
cadcaaccdcdbdbacad	FALSE
cadcaaddaaaacbcbbc	FALSE
cbcacddcdacaaaaadb	FALSE
cbcadaadccbdacddbd	FALSE
ccacababaddadacbcb	FALSE
ccacabbdadababbbdb	FALSE
ccdacbbdcadabbaddb	FALSE
ccdacccdacbaddaddb	FALSE
cdbcbccaababcddddc	FALSE
cdbccbdaddcdcccbdc	FALSE
daabbdcbbbcabccaba	FALSE
daabcbbbdaaadcbcdc	FALSE
dadabcabbddcadbcad	FALSE
dadabccaaacaaaaccb	FALSE
dbbcdcdcbacbaabaaa	FALSE
dbbcddcadbdacddbcd	FALSE
dcaaddddbabccabbca	FALSE
dcabacbcdbabaaaabb	FALSE
dccdcdaacdaddabdab	FALSE
dccdcdbabbccdcbccd	FALSE
ddbbcabcdbabccaaca	FALSE
ddbbcbbacbaddabbcb	FALSE
aaaaacacddaaadbccca	TRUE
aaaabcdcddacccdcaad	TRUE
aacdabcdaaacaaacdad	TRUE
aacdabdcadacddacdac	TRUE
abadddaacacdcdcaaaa	TRUE
abadddacdcadaaaacdc	TRUE
abdcddcddccdaadcacc	TRUE
abdcdddaddaddcccaad	TRUE
acbdddcccdacaaaadac	TRUE
accaabaaccadaaaacaa	TRUE
adabcdacdaaaacdadcc	TRUE
adabcdaddccddddcaca	TRUE
addaabcaddaaaacddca	TRUE
addaabcdddcaddacaac	TRUE
baadcadcdaddaadcdac	TRUE
baadccacddddacadcda	TRUE
badaddaaadacaccdaad	TRUE
badaddacaccddcdccac	TRUE
bcadcaacadaccdcaccd	TRUE
bcadcaacdadcaacdcaa	TRUE
bcdacddaadcaacaccaa	TRUE
bcdacdddcacadcacccd	TRUE
bdadaadadadaacdddcd	TRUE
bdadaadadddaddccacd	TRUE
bddaccaccacdaacacca	TRUE
bddacccaacadddccdcc	TRUE
cabadaadacdcccdadcc	TRUE
cabadaadddcaccacadd	TRUE
caddbccdcacddaacacc	TRUE
caddbcdccdadaaadadc	TRUE
cbcdadcaddaaddadccc	TRUE
cbcdcaaadaacaccadcd	TRUE
ccaddadcdcaaddbcdad	TRUE
ccaddbcdaacadacddad	TRUE
ccdbdddcaadacccdcaa	TRUE
ccdcabdadddddcadddc	TRUE
cdcaaabccdcdacccada	TRUE
cdcaaabdadaccddcaaa	TRUE
daabcddccacccdcdcaa	TRUE
daabdaaaadcdadcadca	TRUE
dadaacabdcdccaaddcc	TRUE
dadaaccddbdcddcccca	TRUE
dbcadacdccaadcacdcc	TRUE
dbcaddadccdaaaddccc	TRUE
dcabaccdaaacdadadaa	TRUE
dcabadaccddacddadaa	TRUE
dccdcdddadadbdaadad	TRUE
dccddabcaddcccdccaa	TRUE
ddbadddddddddacddaa	TRUE
ddbcacacdadaacdccdc	TRUE
aaaaabbbdbacbcccdcb	FALSE
aaaaaddddbdaacbbdcd	FALSE
aacbbcccbbcacbabddd	FALSE
aacbbccddabcdadadbb	FALSE
abadabdcbcbadddaaab	FALSE
abadaccbdabcbabcaba	FALSE
abdbddadabcbbcbddac	FALSE
abdbddcbacbadaacdac	FALSE
accbdbcccdacdbdabdc	FALSE
accbdcddbccccaaddca	FALSE
adbaababbbcbabccabb	FALSE
adbaabbbdddbabbdadc	FALSE
addbbdabdbbddbbbdcb	FALSE
addbbddbdccaabaddac	FALSE
babddaddadaaaaadccd	FALSE
babddcaccdddddaacda	FALSE
bbabddababdccbdbdba	FALSE
bbabddabbcddbbbaccc	FALSE
bbdabdddbacdbbbaddb	FALSE
bbdacaabbdbdddaaacb	FALSE
bcbcaddbabccbcddadb	FALSE
bcbcaddcadbcdabbacb	FALSE
bdaabacabbacbbbbabc	FALSE
bdaabadbcbadacaadaa	FALSE
bdccbcccdaabdcbaadd	FALSE
bdccbcdddacacccddbd	FALSE
cabbdcadccdccabbcbd	FALSE
cabbdcbdcaaabbcaccd	FALSE
caddddaadbcdcbabbab	FALSE
cbaaaabdadadbaccbab	FALSE
cbcbdcbcdbabddbdcad	FALSE
cbccaaadadaaacbaddd	FALSE
ccadbababbbcddabdba	FALSE
ccadbcbcbdadbccdbbb	FALSE
ccdbdcaadabaaabbdbd	FALSE
ccdbdcbcccadbdccdac	FALSE
cdcaababaabcacacbac	FALSE
cdcaabbccbaabaccccc	FALSE
daacdbcadbbdcaddbcd	FALSE
daacdddacdbadbcdbdc	FALSE
dadcbabcbbbdccaaddc	FALSE
dadcbacbdacabccbcdd	FALSE
dbcaaabbbdbacdadccd	FALSE
dbcaaabdacaacbbbaba	FALSE
dcadadddbdcdadcccbc	FALSE
dcadbabdbbbccadcdac	FALSE
dcdbbdcddaabcadaacb	FALSE
dcdbcaaddcccdbdcaaa	FALSE
ddbcbcbabccabbdbcdc	FALSE
ddbcbcdcaabdddcccda	FALSE
